"Hello?"

"Ah. Yes. Good afternoon, Miss White. I'm calling from Color Day's Preschool. The headmaster was very impressed with you after your interview with her. After reviewing all other applicants, she has decided to give you the position of teacher's assistant."

"Oh my gosh! Really?"

"Mmhm. That's right. Now before you say "yes", i'm going to read to you some of the responsibilities you'll need to take on for the job: "You must engage the children, respect them. Clean after them, guide them. And most of all-"

"-Treat them as if they were your own children! Got it."

"**Chuckles** I believe you've already shown your prowess with the kids the other day in front of the headmaster, so she's waved off your "test drive". She'd like you to start next Monday, would that be okay?"

"Yeah, that would totally be okay! Thank you for this opportunity. I'm very, very grateful."

"Alright now, have a good day."

"It's already great! Have a great day to you too. Bye."

Monday.

After slamming the car door shut, you gracefully walk across the Parking Lot towards the school. This is your first day in the real world. After four years of training, this is what you've been waiting for. You push open the glass doors and enter into the Parent Waiting Room. You glance around,
Blanket
An Interactive Fiction by Elana Shi
Release 1 / Serial number 141002 / Inform 7 build 6L38 (I6/v6.33 lib 6/12N) SD

Parking Lot
A large parking lot. There aren't a lot of cars in the lot right now, but a couple hours later and it'll be jam packed. Your car is parked in front of you. To the East is the Parent Waiting Room.

I beg your pardon?

I beg your pardon?

>n
You can't go that way.

>s
You can't go that way.

>e
Parent Waiting Room
The room is a modestly sized rectangular room. Lining the pastel yellow walls are wooden armchairs. In the center of the room, there is a glass coffee table. On it is a neatly stacked pile of magazines. Next to the glass door is a water dispenser machine, with cups on top. Against the north wall is the Reception Desk. Somebody is sitting behind the desk. To the West is the Parking Lot. To the South is the Office.

>kiss girl
The girl might not like that.

>w
Parking Lot
A large parking lot. There aren't a lot of cars in the lot right now, but a couple hours later and it'll be jam packed. Your car is parked in front of you. To the East is the Parent Waiting Room.

You can see Car here.

>e
Parent Waiting Room
The room is a modestly sized rectangular room. Lining the pastel yellow walls are wooden armchairs. In the center of the room, there is a glass coffee table. On it is a neatly stacked pile of magazines. Next to the glass door is a water dispenser machine, with cups on top. Against the north wall is the Reception Desk. Somebody is sitting behind the desk. To the West is the Parking Lot. To the South is the Office.

* * *

>e
Parent Waiting Room
The room is a modestly sized rectangular room. Lining the pastel yellow walls are wooden armchairs. In the center of the room, there is a glass coffee table. On it is a neatly stacked pile of magazines. Next to the glass door is a water dispenser machine, with cups on top. Against the north wall is the Reception Desk. Somebody is sitting behind the desk. To the West is the Parking Lot. To the South is the Office.

>s
Office
The teachers don't really need to grade anything, so only the administration workers need cubicles. There are only four cubicles, two on each side of the walk way at the center. To the West is the Headmaster's Office. To the North is the Parent Waiting Room. To the South is the Playground.

>w
Headmaster's Office
The room is tidy and organized, albeit a little small. There is a shelf of books by one wall, and a sofa on the other. Potted plants hang in front of a large window, overlooking the Parking Lot. At the center of the room is a large wooden desk. There are stacks of papers and forms just waiting to be signed. Behind the desk is the Headmaster, Ms. Color.

>w
You can't go that way.

I beg your pardon?

>e
Office
The teachers don't really need to grade anything, so only the administration workers need cubicles. There are only four cubicles, two on each side of the walk way at the center. To the West is the Headmaster's Office. To the North is the Parent Waiting Room. To the South is the Playground.

>w
Headmaster's Office
The room is tidy and organized, albeit a little small. There is a shelf of books by one wall, and a sofa on the other. Potted plants hang in front of a large window, overlooking the Parking Lot. At the center of the room is a large wooden desk. There are stacks of papers and forms just waiting to be signed. Behind the desk is the Headmaster, Ms. Color.

>e
Office
The teachers don't really need to grade anything, so only the administration workers need cubicles. There are only four cubicles, two on each side of the walk way at the center. To the West is the Headmaster's Office. To the North is the Parent Waiting Room. To the South is the Playground.

* * *

>e
Parent Waiting Room
The room is a modestly sized rectangular room. Lining the pastel yellow walls are wooden armchairs. In the center of the room, there is a glass coffee table. On it is a neatly stacked pile of magazines. Next to the glass door is a water dispenser machine, with cups on top. Against the north wall is the Reception Desk. Somebody is sitting behind the desk. To the West is the Parking Lot. To the South is the Office.

>talk to girl
She looks up briefly, then back down to her phone. She nonchalantly says "Your classroom is in room 102, with Miss Green. To get there, you'll have to go South, past the office, and South East to the Playground. Miss Green's classroom is just South of the Playground."

>ask girl about locked door
She looks up and rolls her eyes. After grabbing a key the desk drawer, she tosses it to you. "Ten bucks if ya" lose it." You thank her, and walk away from the desk.

* * *

>s
You can't go that way.

>w
You can't go that way.

>e
Parent Waiting Room
The room is a modestly sized rectangular room. Lining the pastel yellow walls are wooden armchairs. In the center of the room, there is a glass coffee table. On it is a neatly stacked pile of magazines. Next to the glass door is a water dispenser machine, with cups on top. Against the north wall is the Reception Desk. Somebody is sitting behind the desk. To the West is the Parking Lot. To the South is the Office.

>e
You can't go that way.

>take ceramic pig
You ask if you can take the Ceramic Pig, but the girl at the desk says "Of course not. That's my bus money. I need a dollar to take the bus, and those quarter's are gonna get me home. If you can give me a dollar bill or something, then you can take it." You recall that you left your wallet inside the car.

I beg your pardon?

>open car
You can't see any such thing.

>s
Office
The teachers don't really need to grade anything, so only the administration workers need cubicles. There are only four cubicles, two on each side of the walk way at the center. To the West is the Headmaster's Office. To the North is the Parent Waiting Room. To the South is the Playground.

>n
You can't go that way.

>e
You can't go that way.

>w
You can't go that way.

>n
You can't go that way.

I beg your pardon?

>e
You can't go that way.

* * *

>w
You can't go that way.

>s
You can't go that way.

>n
You can't go that way.

* * *

>open car
You open Car, revealing Wallet.

>take wallet
Taken.

>open wallet
You open Wallet, revealing Dollar Bill.

>x wallet
A small white leather wallet that you got as a graduation present. Inside are a couple of wrinkled bills.

In Wallet is Dollar Bill.

* * *

>open car
You open Car, revealing Wallet.

>open wallet
You open Wallet, revealing Dollar Bill.

>take dollar bill
Taken.