"Hello?"

"Ah. Yes. Good afternoon, Miss White. I'm calling from Color Day's Preschool. The headmaster was very impressed with you after your interview with her. After reviewing all other applicants, she has decided to give you the position of teacher's assistant."

"Oh my gosh! Really?"

"Mmhm. That's right. Now before you say "yes", i'm going to read to you some of the responsibilities you'll need to take on for the job: "You must engage the children, respect them. Clean after them, guide them. And most of all-"

"-Treat them as if they were your own children! Got it."

"**Chuckles** I believe you've already shown your prowess with the kids the other day in front of the headmaster, so she's waved off your "test drive". She'd like you to start next Monday, would that be okay?"

"Yeah, that would totally be okay! Thank you for this opportunity. I'm very, very grateful."

"Alright now, have a good day."

"It's already great! Have a great day to you too. Bye."

Monday.

After slamming the car door shut, you gracefully walk across the Parking Lot towards the school. This is your first day in the real world. After four years of training, this is what you've been waiting for. You push open the glass doors and enter into the Parent Waiting Room. You glance around,
Blanket
An Interactive Fiction by Elana Shi
Release 1 / Serial number 141001 / Inform 7 build 6L38 (I6/v6.33 lib 6/12N) SD

Parking Lot
A large parking lot. There aren't a lot of cars in the lot right now, but a couple hours later and it'll be jam packed. Your car is parked in front of you. To the East is the Parent Waiting Room.

You can see Car here.

I beg your pardon?

* * *

>e
Parent Waiting Room
The room is a modestly sized rectangular room. Lining the pastel yellow walls are wooden armchairs. In the center of the room, there is a glass coffee table. On it is a neatly stacked pile of magazines. Next to the glass door is a water dispenser machine, with cups on top. Against the north wall is the Reception Desk. Somebody is sitting behind the desk. To the West is the Parking Lot. To the South is the Office.