"Hello?"

"Ah. Yes. Good afternoon, Miss White. I'm calling from Color Day's Preschool. The headmaster was very impressed with you after your interview with her. After reviewing all other applicants, she has decided to give you the position of teacher's assistant."

"Oh my gosh! Really?"

"Mmhm. That's right. Now before you say "yes", I'm going to read to you some of the responsibilities you'll need to take on for the job: "You must engage the children, respect them. Clean after them, guide them. And most of all-"

"-Treat them as if they were your own children! Got it."

"**Chuckles** I believe you've already shown your prowess with the kids the other day in front of the headmaster, so she's waved off your "test drive". She'd like you to start next Monday, would that be okay?"

"Yeah, that would totally be okay! Thank you for this opportunity. I'm very, very grateful."

"Alright now, have a good day."

"It's already great! Have a great day to you too. Bye."

Monday:

After slamming the car door shut, you gracefully walk across the Parking Lot towards the school. This is your first day in the real world. After four years of training, this is what you've been waiting for. You push open the glass doors and enter into the Parent Waiting Room. You glance around,

~
Child's Play
An Interactive Fiction by Elana Shi
Release 1 / Serial number 141002 / Inform 7 build 6L38 (I6/v6.33 lib 6/12N) SD

Parent Waiting Room
The room is a modestly sized rectangular room. Lining the pastel yellow walls are wooden armchairs. Against the north wall is the reception cesk. There is a girl sitting behind the desk. To the West is the Parking Lot. To the South is the Office.

I beg your pardon?

>w
Parking Lot
A large parking lot. There aren't a lot of cars in the lot right now, but a couple hours later and it'll be jam packed. Your car is parked in front of you. To the East is the Parent Waiting Room.

* * *

>take wallet
You can't see any such thing.

>take car
That's hardly portable.

>open car
You open Car, revealing Wallet.

* * *

>take wallet
Taken.

>open wallet
You open Wallet, revealing Dollar Bill.

* * *

>w
You can't go that way.

>e
Parent Waiting Room
The room is a modestly sized rectangular room. Lining the pastel yellow walls are wooden armchairs. Against the north wall is the Reception Desk. Somebody is sitting behind the desk. To the West is the Parking Lot. To the South is the Office.

>give dollar bill to the girl
You hand her the Dollar Bill, and she nods her head to the Ceramic Pig. You can take four quarters." You take the Ceramic Pig, and pull the rubber stopper from under it. Gently shaking the Ceramic Pig, four quarters fall into your palm. You put the Ceramic Pig back, and thank the girl.

>s
Office
The teachers don't really need to grade anything, so only the administration workers need cubicles. There are only four cubicles, two on each side of the walk way at the center. To the North is the Parent Waiting Room. To the West is the Lounge. To the South is the Playground.

I beg your pardon?

>s
Classroom
A somewhat large room, walls covered in posters. The floor is cluttered with toys and furniture. Small children run around, screaming at each other. Some of the younger children sit dumbly on a brightly colored rug, chewing on some poor plastic toy. There is a large window on the west wall, overlooking the playground. Along the four walls are cubby holes and shelves. Mrs. Green, the teacher, stands by the window, consoling a crying child.

You can see Funiture here.

I beg your pardon?

* * *

>take dollar
Taken.

>x
(Dollar Bill)
Worth one dollar.

>e
Parent Waiting Room
The room is a modestly sized rectangular room. Lining the pastel yellow walls are wooden armchairs. Against the north wall is the reception cesk. There is a girl sitting behind the desk. To the West is the Parking Lot. To the South is the Office.

>talk to girl
She looks up briefly, then back down to her phone. She nonchalantly says, "You're with Miss Green. To get to her classroom, you'll have to go through the office.

>show girl dollar
You hand her the Dollar Bill, and she nods her head to the Ceramic Pig. You can take four quarters." You take the Ceramic Pig, and pull the rubber stopper from under it. Gently shaking the Ceramic Pig, four quarters fall into your palm. You put the Ceramic Pig back, and thank the girl.

>give girl dollar
You can't see any such thing.

>ask
(the girl for Quarters)
(the girl first taking Quarters)
The girl has better things to do.

>j
That's not a verb I recognise.

>w
Parking Lot
A large parking lot. There aren't a lot of cars in the lot right now, but a couple hours later and it'll be jam packed. Your car is parked in front of you. To the East is the Parent Waiting Room.

I beg your pardon?

>e
Parent Waiting Room
The room is a modestly sized rectangular room. Lining the pastel yellow walls are wooden armchairs. Against the north wall is the reception cesk. There is a girl sitting behind the desk. To the West is the Parking Lot. To the South is the Office.

>s
Office
The teachers don't really need to grade anything, so only the administration workers need cubicles. There are only four cubicles, two on each side of the walk way at the center. As you scan the room, a woman walks past. Her nametag reads "Miss Graham: Headmaster". To the North is the Parent Waiting Room. To the West is the Lounge. To the South is the Classroom.

You can see Miss Graham here.

>s
Classroom
A somewhat large room, walls covered in posters. The floor is cluttered with toys and furniture. Small children run around, screaming at each other. Some of the younger children sit dumbly on a brightly colored rug, chewing on some poor plastic toy. There is a large window on the west wall, overlooking the playground. Along the four walls are cubby holes and shelves. The Office is to the North, and the Playground is to the West. Mrs. Green, the teacher, stands by the window, consoling a crying child.

>ask mrs. green about brown rag
I didn't understand that sentence.

>ask mrs. green about george
I didn't understand that sentence.

* * *

>take dollar
Taken.

>w
You can't go that way.

* * *

>s
You can't go that way.

>e
Parent Waiting Room
The room is a modestly sized rectangular room. Lining the pastel yellow walls are wooden armchairs. Against the north wall is the reception cesk. There is a girl sitting behind the desk. To the West is the Parking Lot. To the South is the Office.

>show dollar to girl
You hand her the Dollar Bill, and she nods her head to the Ceramic Pig. You can take four quarters." You take the Ceramic Pig, and pull the rubber stopper from under it. Gently shaking the Ceramic Pig, four quarters fall into your palm. You put the Ceramic Pig back, and thank the girl.

>i
You are carrying:
  Quarters

>w
Parking Lot
A large parking lot. There aren't a lot of cars in the lot right now, but a couple hours later and it'll be jam packed. Your car is parked in front of you. To the East is the Parent Waiting Room.

>e
Parent Waiting Room
The room is a modestly sized rectangular room. Lining the pastel yellow walls are wooden armchairs. Against the north wall is the reception cesk. There is a girl sitting behind the desk. To the West is the Parking Lot. To the South is the Office.

>s
Office
The teachers don't really need to grade anything, so only the administration workers need cubicles. There are only four cubicles, two on each side of the walk way at the center. As you scan the room, a woman walks past. Her nametag reads "Miss Graham: Headmaster". To the North is the Parent Waiting Room. To the West is the Lounge. To the South is the Classroom.

>w
Lounge
There is a microwave and a sink at the counter, below which are a couple of drawers. At the center of the room is a round table. Because this is a preschool, there is also a washer dryer machine in the far corner.

>put quarters in washer-dryer
Washer-Dryer Machine is closed.

>open washer dryer machine
You can't see any such thing.

* * *

>speak to girl
I didn't understand that sentence.

* * *

>x reception desk
The desk is very large, taking up almost half of the wall. On it is the wooden clipboard. Parents are asked to sign their children out before they take them home. There are a number of little trinkets and decorations on the top level of the shelf including a potted plant and a ceramic pig. There is a girl sitting behind the desk.

>talk to girl
She looks up briefly, then back down to her phone. She nonchalantly says "You're with Miss Green. To get to her classroom, you'll have to go through the office.

* * *

>open car
You open Car, revealing Wallet.

* * *

>open wallet
You open Wallet, revealing Dollar Bill.

>x wallet
A small white leather wallet that you got as a graduation present. Inside are a couple of wrinkled bills.

In Wallet is Dollar Bill.

* * *

>e
Parent Waiting Room
The room is a modestly sized rectangular room. Lining the pastel yellow walls are wooden armchairs. In the center of the room, there is a glass coffee table. On it is a neatly stacked pile of magazines. Next to the glass door is a water dispenser machine, with cups on top. Against the north wall is the Reception Desk. Somebody is sitting behind the desk. To the West is the Parking Lot. To the South is the Office.

* * *

>w
Parking Lot
A large parking lot. There aren't a lot of cars in the lot right now, but a couple hours later and it'll be jam packed. Your car is parked in front of you. To the East is the Parent Waiting Room.

* * *

>s
Office
The teachers don't really need to grade anything, so only the administration workers need cubicles. There are only four cubicles, two on each side of the walk way at the center. As you scan the room, a woman walks past. Her nametag reads "Miss Graham: Headmaster". To the North is the Parent Waiting Room. To the West is the Lounge. To the South is the Classroom.

>w
Lounge
There is a microwave and a sink at the counter, below which are a couple of drawers. At the center of the room is a round table. Because this is a preschool, there is also a washer-dryer machine in the far corner.

>open washer dryer machine
You can't see any such thing.

I beg your pardon?

>open washer-dryer machine
It seems to be locked.

>w
You can't go that way.

* * *

>e
Office
The teachers don't really need to grade anything, so only the administration workers need cubicles. There are only four cubicles, two on each side of the walk way at the center. As you scan the room, a woman walks past. Her nametag reads "Miss Graham: Headmaster". To the North is the Parent Waiting Room. To the West is the Lounge. To the South is the Classroom.

>n
Parent Waiting Room
The room is a modestly sized rectangular room. Lining the pastel yellow walls are wooden armchairs. Against the north wall is the reception cesk. There is a girl sitting behind the desk. To the West is the Parking Lot. To the South is the Office.

>w
Parking Lot
A large parking lot. There aren't a lot of cars in the lot right now, but a couple hours later and it'll be jam packed. Your car is parked in front of you. To the East is the Parent Waiting Room.

* * *

>w
Lounge
There is a microwave and a sink at the counter, below which are a couple of drawers. At the center of the room is a round table. Because this is a preschool, there is also a washer-dryer machine in the far corner.

>open washer-dryer
It seems to be locked.

>unlock washer-dryer
(with Dollar Bill)
That doesn't seem to fit the lock.

>i
You are carrying:
  Dollar Bill

>w
You can't go that way.

* * *

>n
Parent Waiting Room
The room is a modestly sized rectangular room. Lining the pastel yellow walls are wooden armchairs. Against the north wall is the reception cesk. There is a girl sitting behind the desk. To the West is the Parking Lot. To the South is the Office.

>show girl dollar
You hand her the Dollar Bill, and she nods her head to the Ceramic Pig. You can take four quarters." You take the Ceramic Pig, and pull the rubber stopper from under it. Gently shaking the Ceramic Pig, four quarters fall into your palm. You put the Ceramic Pig back, and thank the girl.

>w
Parking Lot
A large parking lot. There aren't a lot of cars in the lot right now, but a couple hours later and it'll be jam packed. Your car is parked in front of you. To the East is the Parent Waiting Room.

>s
You can't go that way.

* * *

>w
Lounge
There is a microwave and a sink at the counter, below which are a couple of drawers. At the center of the room is a round table. Because this is a preschool, there is also a washer-dryer machine in the far corner.

>unlock washer-dryer
(with Quarters)
You unlock Washer-Dryer Machine.

>i
You are carrying:
  Quarters

>put quarters in washing machine
You can't see any such thing.

>put quarters in washer-dryer
Washer-Dryer Machine is closed.

>open washer dryer
You can't see any such thing.

>open washer-dryer
You open Washer-Dryer Machine.

>put quarters in washer-dryer
You put Quarters into Washer-Dryer Machine.

>close washer dryer
You can't see any such thing.

>washer-dryer
That's not a verb I recognise.

* * *

>s
Classroom
A somewhat large room, walls covered in posters. The floor is cluttered with toys and furniture. Small children run around, screaming at each other. Some of the younger children sit dumbly on a brightly colored rug, chewing on some poor plastic toy. There is a large window on the west wall, overlooking the playground. Along the four walls are cubby holes and shelves. The Office is to the North, and the Playground is to the West. Mrs. Green, the teacher, stands by the window, consoling a crying child.

>s
You can't go that way.

>l
Classroom
A somewhat large room, walls covered in posters. The floor is cluttered with toys and furniture. Small children run around, screaming at each other. Some of the younger children sit dumbly on a brightly colored rug, chewing on some poor plastic toy. There is a large window on the west wall, overlooking the playground. Along the four walls are cubby holes and shelves. Mrs. Green, the teacher, stands by the window, consoling a crying child.

>speak to mrs. green
I didn't understand that sentence.

>talk to mrs. green
You walk up to Mrs. Green and introduce yourself. "Thank the Lord that you're here! This is George," she says, gesturing to the crying child. "Right now, I need you to get him to stop crying. I really need to get the kids in order, and a wailing child does not help!" George, a small boy, looks to you as Mrs. Green hurries away to settle another dispute.

That's not a verb I recognise.

I beg your pardon?

>speak to mrs. green
I didn't understand that sentence.

* * *

>talk to mrs. green
You walk up to Mrs. Green and introduce yourself. "Thank the Lord that you're here! This is George," she says, gesturing to the crying child. "Right now, I need you to get him to stop crying. I really need to get the kids in order, and a wailing child does not help!" George, a small boy, looks to you as Mrs. Green hurries away to settle another dispute.

That's not a verb I recognise.

>talk to mrs. green
You walk up to Mrs. Green and introduce yourself. "Thank the Lord that you're here! This is George," she says, gesturing to the crying child. "Right now, I need you to get him to stop crying. I really need to get the kids in order, and a wailing child does not help!" George, a small boy, looks to you as Mrs. Green hurries away to settle another dispute.

That's not a verb I recognise.

>talk to george
You ask George what's wrong. He wails, "B-blanky is gone." Blanky? What's that?

>ask george about blanky
"Soft blanky. Is blue, and soft. I want it!" You ask him where he saw it last, to which he replies "Playground! I ride car and put it on my head. It fall down and I lost it. Then the car broke."

* * *

>e
You can't go that way.

>w
Playground
An open grassy space for the children to play in. There is a small plastic jungle gym at the center of the space for the older kids to play in. Next to it is a large wooden sandbox. Scattered around the grass is are jump ropes, balls, and a plastic toy cart.

>take brown rag
Taken.

>n
You can't go that way.

>n
You can't go that way.

>e
Classroom
A somewhat large room, walls covered in posters. The floor is cluttered with toys and furniture. Small children run around, screaming at each other. Some of the younger children sit dumbly on a brightly colored rug, chewing on some poor plastic toy. There is a large window on the west wall, overlooking the playground. Along the four walls are cubby holes and shelves. The Office is to the North, and the Playground is to the West. Mrs. Green, the teacher, stands by the window, consoling a crying child.

>ask mrs. green about brown rag
I didn't understand that sentence.

>ask mrs. green about blanket
I didn't understand that sentence.

>give brown rag to george
It's dirty! You can't give it to him like this. He might want it, but it's not going to please his parents.

>Show brown rag to george
It's dirty! You can't give it to him like this. He might want it, but it's not going to please his parents.

I beg your pardon?

>give mrs. green brown rag
You can't see any such thing.

>talk to mrs. green
You walk up to Mrs. Green, and say "Hello.". She sighs in relief and says, "Thank the Lord that you're here! This is George," she says, gesturing to the crying child. "Right now, I need you to get him to stop crying. I really need to get the kids in order, and a wailing child does not help!" George, a small boy, looks to you as Mrs. Green hurries away to settle another dispute.

That's not a verb I recognise.

* * *

>s
Classroom
A somewhat large room, walls covered in posters. The floor is cluttered with toys and furniture. Small children run around, screaming at each other. Some of the younger children sit dumbly on a brightly colored rug, chewing on some poor plastic toy. There is a large window on the west wall, overlooking the playground. Along the four walls are cubby holes and shelves. The Office is to the North, and the Playground is to the West. Mrs. Green, the teacher, stands by the window, consoling a crying child.

>e
You can't go that way.

* * *

>w
Playground
An open grassy space for the children to play in. There is a small plastic jungle gym at the center of the space for the older kids to play in. Next to it is a large wooden sandbox. Scattered around the grass is are jump ropes, balls, and a plastic toy cart.

I beg your pardon?

>x cart
Red body, yellow roof. The Cozy Coupe: a classic. You push the cart a little bit, and discover the wheels don't move.

>x wheels
You can't see any such thing.

>x wheel
Caught between the black plastic wheel and the metal hook is a blue blanket. It must be George's. You tug the blanket, but it remains stuck. You might need to take the wheel off with a screwdriver. There might be some tools in the Closet.

>take blanket
You can't, it's stuck to the wheel.

I beg your pardon?

>s
Closet
fdsa.

You can see Screwdriver here.

* * *

>w
Playground
An open grassy space for the children to play in. There is a small plastic jungle gym at the center of the space for the older kids to play in. Next to it is a large wooden sandbox. Scattered around the grass is are jump ropes, balls, and a plastic toy cart.

>s
Closet
fdsa.

You can see Screwdriver here.

>take screwdriver
Taken.

* * *

>s
Office
The teachers don't really need to grade anything, so only the administration workers need cubicles. There are only four cubicles, two on each side of the walk way at the center. As you scan the room, a woman walks past. Her nametag reads "Miss Graham: Headmaster". To the North is the Parent Waiting Room. To the West is the Lounge. To the South is the Classroom.

>ask miss graham about brown rag
You show her the brown rag and explain the situation. She laughs and says, "Don't worry. There's a washer-dryer machine in the faculty lounge. You can wash the blanket there.