Alice White: a freshly graduated girl, who succeeds in getting her first job as a teacher's assistant at Sunny Day Preschool. She is passionate about what she does and is enthusiastic about doing well on her first job in the "real world". Her first task at the school is to help the teacher, Miss Mary, to get a child to stop crying.

"Hello?"

"Ah. Yes. Good afternoon, Miss White. I am the Headmaster of Sunny Day Preschool, Miss Graham. I was very impressed with you after your interview the other day. After reviewing all other applicants, I've decided to give you the position of teacher's assistant."

"Oh my gosh! Really?"

"Mmhm. That's right. Now before you say "yes", I'm going to read to you some of the responsibilities you'll need to take on for the job: "You must engage the children, respect them. Clean after them, guide them. And most of all-"

"-Treat them as if they were your own children! Got it."

"**Chuckles** You've already shown your prowess with the kids the other day, so I've waved off your "test drive". I'd like you to start next Monday, would that be okay?"

"Yeah, that would totally be okay! Thank you for this opportunity. I'm very, very grateful."

"Alright now, have a good day."

"It's already great! Have a great day to you too. Bye."

Monday:

After slamming the car door shut, you stride across the Parking Lot towards the school. This is your first day in the real world. After four years of training, this is what you've been waiting for. You push open the glass doors and enter into the Parent Waiting Room. You glance around,

~
Child's Play
An Interactive Fiction by Elana Shi
Release 1 / Serial number 141007 / Inform 7 build 6L38 (I6/v6.33 lib 6/12N) SD

Parent Waiting Room
The room is a modestly sized rectangular room. On the walls is a large bulletin board. Against the north wall is the reception desk. There is a girl sitting behind the desk. To the West is the Parking Lot. To the South is the Office.

I beg your pardon?

I beg your pardon?

>x wall
Pastel yellow- a neutral color. It's quite calming, actually.

>x bulletin board
There are lots of pictures of smiling children and field trip notifications tacked onto the board.

>x reception desk
The desk is very large, taking up almost half of the wall. There are a number of little trinkets and decorations including a potted plant and a ceramic pig. There is a girl sitting behind the desk.

>x girl
She is sitting behind the desk, furiously texting into her phone. She doesn't even notice that you've walked up to her.

>talk to girl
She looks up briefly, then back down to her phone. She nonchalantly says, "You're with Miss Mary. I recommend you speak to her first. To get to her classroom, you'll have to go through the office."

I beg your pardon?

>s
Office
The teachers don't really need to grade anything, so only the administration workers need cubicles. There are only four cubicles, two on each side of the walk way at the center. As you scan the room, a woman walks past. Her nametag reads "Miss Graham: Headmaster". To the North is the Parent Waiting Room. To the West is the Lounge. To the South is the Classroom.

>talk to miss graham
You approach Miss Graham, and she turns to you. She smiles and says "Hello, Miss White. I hope your first day is going well. If you have any problems or questions, please feel free to ask me. Now move along, you should be in Miss Mary's classroom."

>s
Classroom
A somewhat large room, walls covered in posters. The floor is cluttered with toys and furniture. Small children run around, screaming at each other. Some of the younger children sit dumbly on a brightly colored rug, chewing on some poor plastic toy. There is a large window on the west wall, overlooking the playground. Along the four walls are cubby holes. The Office is to the North, and the Playground is to the West. Miss Mary, the teacher, stands by the window, consoling a crying child.

>x miss mary
A middle aged woman in her 40s, Miss Mary is somewhat plump. She wears a demin dress that stretches tightly around her gut. You're amazed that she can move in it.

>talk to miss mary
You walk up to Miss Mary, and say "Hello." She sighs in relief and says, "Thank the Lord that you're here! This is George," she says, gesturing to the crying child. "Right now, I need you to get him to stop crying. I really need to get the kids in order, and a wailing child does not help!" George, a small boy, looks to you as Miss Mary hurries away to settle another dispute.

>speak to george
You ask George what's wrong. He wails, "B-blanky is gone." Blanky? What's that? Ask him about it.

>ask george about blanky
"Soft blanky. Is blue, and soft. I want it!" You ask him where he saw it last, to which he replies "Playground! Morning recess I ride cart and put it on my head. It fall down and I losed it. Then the cart broke."

>s
You can't go that way.

>w
Playground
An open grassy space for the children to play in. There is a small plastic jungle gym at the center of the space for the older kids to play in. Next to it is a large wooden sandbox. Scattered around the grass are jump ropes, balls, and a plastic toy cart. Sounds of giggling children come from the Classroom, to the East.

>x cart
Red body, yellow roof. The Cozy Coupe: a classic. You push the cart a little bit, and discover one of the wheels don't move.

>x wheel
Black plastic wheel attached to the cart. Wheel is detachable.

>take wheel
You take the wheel. Looks like there's a Brown Cloth inside the hollow of the wheel.

>take brown cloth
Taken.

>take wheel
You already have that.

>e
Classroom
A somewhat large room, walls covered in posters. The floor is cluttered with toys and furniture. Small children run around, screaming at each other. Some of the younger children sit dumbly on a brightly colored rug, chewing on some poor plastic toy. There is a large window on the west wall, overlooking the playground. Along the four walls are cubby holes. The Office is to the North, and the Playground is to the West. Miss Mary, the teacher, stands by the window, consoling a crying child.

I beg your pardon?

>give george blanky
It's dirty! You can't give it to him like this. He might want it, but it's not going to please his parents.

>give george brown rag
I only understood you as far as wanting to give George Brown Cloth.

I beg your pardon?

>give george brown cloth
It's dirty! You can't give it to him like this. He might want it, but it's not going to please his parents.

>s
You can't go that way.

* * *

>w
Playground
An open grassy space for the children to play in. There is a small plastic jungle gym at the center of the space for the older kids to play in. Next to it is a large wooden sandbox. Scattered around the grass are jump ropes, balls, and a plastic toy cart. Sounds of giggling children come from the Classroom, to the East.

>e
Classroom
A somewhat large room, walls covered in posters. The floor is cluttered with toys and furniture. Small children run around, screaming at each other. Some of the younger children sit dumbly on a brightly colored rug, chewing on some poor plastic toy. There is a large window on the west wall, overlooking the playground. Along the four walls are cubby holes. The Office is to the North, and the Playground is to the West. Miss Mary, the teacher, stands by the window, consoling a crying child.

>n
Office
The teachers don't really need to grade anything, so only the administration workers need cubicles. There are only four cubicles, two on each side of the walk way at the center. As you scan the room, a woman walks past. Her nametag reads "Miss Graham: Headmaster". To the North is the Parent Waiting Room. To the West is the Lounge. To the South is the Classroom.

>speak to miss graham
You approach Miss Graham, and she turns to you. She smiles and says "Hello, Miss White. I hope your first day is going well. If you have any problems or questions, please feel free to ask me. Now move along, you should be in Miss Mary's classroom."

>ask miss graham about brown cloth
You show her the brown Cloth and explain the situation. She laughs and says, "Don't worry. There's a washer-dryer machine in the faculty lounge. You can wash the blanket there.

>e
You can't go that way.

>w
Lounge
There is a microwave and a sink at the counter. At the center of the room is a round table. Because this is a preschool, there is also a washer-dryer machine in the far corner. To the East is the Office.

>x machine
The MACHINE is combination of both washing machine and drying machine, a practical necessity for a preschool! The only problem is you need to insert quarters into the machine to UNLOCK the lid in order to open the machine. There should be a bowl full of quarters on the table.

>x bowl
The bowl should have quarters for the Washer-Dryer machine, but it's empty! "I saw a ceramic pig thing on the reception desk... that girl must've stolen all the coins from the bowl for herself!" you think to yourself.

>e
Office
The teachers don't really need to grade anything, so only the administration workers need cubicles. There are only four cubicles, two on each side of the walk way at the center. As you scan the room, a woman walks past. Her nametag reads "Miss Graham: Headmaster". To the North is the Parent Waiting Room. To the West is the Lounge. To the South is the Classroom.

>n
Parent Waiting Room
The room is a modestly sized rectangular room. On the walls is a large bulletin board. Against the north wall is the reception desk. There is a girl sitting behind the desk. To the West is the Parking Lot. To the South is the Office.

>take ceramic pig
You ask if you can take the Ceramic Pig, but the girl at the desk says "Of course not. That's my bus money. I need a dollar to take the bus, and those quarter's are gonna get me home. If you can give me a dollar bill or something, then you can take it." You recall that you left your wallet inside the car.

>e
You can't go that way.

>w
Parking Lot
A large parking lot. There aren't a lot of cars in the lot right now, but a couple hours later and it'll be jam packed. Your car is parked in front of you. To the East is the Parent Waiting Room.

>open car
It seems to be locked.

>unlock car with key
You unlock Car.

>open car
After pulling the door open, you stick your head into car. After rummaging around, you find your wallet lying under the carseat.

>take wallet
Taken.

>open wallet
You open the wallet, revealing a dollar bill, hastily shoved into the bill compartment.

>take bill
Taken.

>e
Parent Waiting Room
The room is a modestly sized rectangular room. On the walls is a large bulletin board. Against the north wall is the reception desk. There is a girl sitting behind the desk. To the West is the Parking Lot. To the South is the Office.

>give girl dollar
You hand her the Dollar Bill, and she nods her head to the Ceramic Pig. "You can take four quarters." You take the Ceramic Pig, and pull the rubber stopper from under it. Gently shaking the Ceramic Pig, four quarters fall into your palm. You put the Ceramic Pig back, and thank the girl.

>i
You are carrying:
  Quarters
  Wallet (open but empty)
  Brown Cloth
  Wheel
  Key

>e
You can't go that way.

* * *

>w
Parking Lot
A large parking lot. There aren't a lot of cars in the lot right now, but a couple hours later and it'll be jam packed. Your car is parked in front of you. To the East is the Parent Waiting Room.

>e
Parent Waiting Room
The room is a modestly sized rectangular room. On the walls is a large bulletin board. Against the north wall is the reception desk. There is a girl sitting behind the desk. To the West is the Parking Lot. To the South is the Office.

>s
Office
The teachers don't really need to grade anything, so only the administration workers need cubicles. There are only four cubicles, two on each side of the walk way at the center. As you scan the room, a woman walks past. Her nametag reads "Miss Graham: Headmaster". To the North is the Parent Waiting Room. To the West is the Lounge. To the South is the Classroom.

>s
Classroom
A somewhat large room, walls covered in posters. The floor is cluttered with toys and furniture. Small children run around, screaming at each other. Some of the younger children sit dumbly on a brightly colored rug, chewing on some poor plastic toy. There is a large window on the west wall, overlooking the playground. Along the four walls are cubby holes. The Office is to the North, and the Playground is to the West. Miss Mary, the teacher, stands by the window, consoling a crying child.

>n
Office
The teachers don't really need to grade anything, so only the administration workers need cubicles. There are only four cubicles, two on each side of the walk way at the center. As you scan the room, a woman walks past. Her nametag reads "Miss Graham: Headmaster". To the North is the Parent Waiting Room. To the West is the Lounge. To the South is the Classroom.

>w
Lounge
There is a microwave and a sink at the counter. At the center of the room is a round table. Because this is a preschool, there is also a washer-dryer machine in the far corner. To the East is the Office.

>unlock machine with quarters
You unlock Washer-Dryer Machine.

* * *

I beg your pardon?

>put brown cloth in machine
You put Brown Cloth into Washer-Dryer Machine.

You adjust the options to "Speed Wash" and press the Power Button. The washer-dryer whirs to life, and you wait 15 minutes before a beeping sound blares from the machine. You take out George's blanket, now soft and fresh (and blue).

>i
You are carrying:
  Blanket
  Wallet (open but empty)
  Wheel
  Key

>w
You can't go that way.

>e
Office
The teachers don't really need to grade anything, so only the administration workers need cubicles. There are only four cubicles, two on each side of the walk way at the center. As you scan the room, a woman walks past. Her nametag reads "Miss Graham: Headmaster". To the North is the Parent Waiting Room. To the West is the Lounge. To the South is the Classroom.

>s
Classroom
A somewhat large room, walls covered in posters. The floor is cluttered with toys and furniture. Small children run around, screaming at each other. Some of the younger children sit dumbly on a brightly colored rug, chewing on some poor plastic toy. There is a large window on the west wall, overlooking the playground. Along the four walls are cubby holes. The Office is to the North, and the Playground is to the West. Miss Mary, the teacher, stands by the window, consoling a crying child.

>give george blanket
You proudly hand the blanket to George. You're about to reprimand "Do you know the trouble I went through to get that, Mister?" when George squeals in delight. You can't help but laugh. You decide to keep that thought to yourself because George doesn't need to know that.

    *** The End ***

Would you like to RESTART, RESTORE a saved game, QUIT or UNDO the last command?

* * *

>x armchairs
You see nothing special about Armchairs.

>x desk
The desk is very large, taking up almost half of the wall. On it is the wooden clipboard. Parents are asked to sign their children out before they take them home. There are a number of little trinkets and decorations on the top level of the shelf including a potted plant and a ceramic pig. There is a girl sitting behind the desk.

>x clipboard
You can't see any such thing.

>x trinkets
You can't see any such thing.

>l
Parent Waiting Room
The room is a modestly sized rectangular room. Lining the pastel yellow walls are wooden armchairs. Against the north wall is the reception desk. There is a girl sitting behind the desk. To the West is the Parking Lot. To the South is the Office.

>talk to girl
She looks up briefly, then back down to her phone. She nonchalantly says, "You're with Miss Green. To get to her classroom, you'll have to go through the office.

>l
Parent Waiting Room
The room is a modestly sized rectangular room. Lining the pastel yellow walls are wooden armchairs. Against the north wall is the reception desk. There is a girl sitting behind the desk. To the West is the Parking Lot. To the South is the Office.

>s
Office
The teachers don't really need to grade anything, so only the administration workers need cubicles. There are only four cubicles, two on each side of the walk way at the center. As you scan the room, a woman walks past. Her nametag reads "Miss Graham: Headmaster". To the North is the Parent Waiting Room. To the West is the Lounge. To the South is the Classroom.

>s
Classroom
A somewhat large room, walls covered in posters. The floor is cluttered with toys and furniture. Small children run around, screaming at each other. Some of the younger children sit dumbly on a brightly colored rug, chewing on some poor plastic toy. There is a large window on the west wall, overlooking the playground. Along the four walls are cubby holes and shelves. The Office is to the North, and the Playground is to the West. Mrs. Green, the teacher, stands by the window, consoling a crying child.

>x window
You can't see any such thing.

>talk to mrs. green
You walk up to Mrs. Green, and say "Hello.". She sighs in relief and says, "Thank the Lord that you're here! This is George," she says, gesturing to the crying child. "Right now, I need you to get him to stop crying. I really need to get the kids in order, and a wailing child does not help!" George, a small boy, looks to you as Mrs. Green hurries away to settle another dispute.

That's not a verb I recognise.

>x george
You see nothing special about George.

>l
Classroom
A somewhat large room, walls covered in posters. The floor is cluttered with toys and furniture. Small children run around, screaming at each other. Some of the younger children sit dumbly on a brightly colored rug, chewing on some poor plastic toy. There is a large window on the west wall, overlooking the playground. Along the four walls are cubby holes and shelves. The Office is to the North, and the Playground is to the West. Mrs. Green, the teacher, stands by the window, consoling a crying child.

>x poster
You can't see any such thing.

>x posters
You can't see any such thing.

>take george
I don't suppose George would care for that.

>l
Classroom
A somewhat large room, walls covered in posters. The floor is cluttered with toys and furniture. Small children run around, screaming at each other. Some of the younger children sit dumbly on a brightly colored rug, chewing on some poor plastic toy. There is a large window on the west wall, overlooking the playground. Along the four walls are cubby holes and shelves. The Office is to the North, and the Playground is to the West. Mrs. Green, the teacher, stands by the window, consoling a crying child.

>x cubbies
You can't see any such thing.

>x shelves
You can't see any such thing.

>talk to mrs. green
You walk up to Mrs. Green, and say "Hello.". She sighs in relief and says, "Thank the Lord that you're here! This is George," she says, gesturing to the crying child. "Right now, I need you to get him to stop crying. I really need to get the kids in order, and a wailing child does not help!" George, a small boy, looks to you as Mrs. Green hurries away to settle another dispute.

That's not a verb I recognise.

* * *

>x george
You see nothing special about George.

>take george
I don't suppose George would care for that.

* * *

>l
Classroom
A somewhat large room, walls covered in posters. The floor is cluttered with toys and furniture. Small children run around, screaming at each other. Some of the younger children sit dumbly on a brightly colored rug, chewing on some poor plastic toy. There is a large window on the west wall, overlooking the playground. Along the four walls are cubby holes and shelves. The Office is to the North, and the Playground is to the West. Mrs. Green, the teacher, stands by the window, consoling a crying child.

>n
Office
The teachers don't really need to grade anything, so only the administration workers need cubicles. There are only four cubicles, two on each side of the walk way at the center. As you scan the room, a woman walks past. Her nametag reads "Miss Graham: Headmaster". To the North is the Parent Waiting Room. To the West is the Lounge. To the South is the Classroom.

>talk to Miss Graham
You approach Miss Graham, and she turns to you. She smiles and says "Hello, Miss White. I hope your first day is going well. If you have any problems or questions, please feel free to ask me."

>n
Parent Waiting Room
The room is a modestly sized rectangular room. Lining the pastel yellow walls are wooden armchairs. Against the north wall is the reception desk. There is a girl sitting behind the desk. To the West is the Parking Lot. To the South is the Office.

>take trinkets
You can't see any such thing.

>x desk
The desk is very large, taking up almost half of the wall. On it is the wooden clipboard. Parents are asked to sign their children out before they take them home. There are a number of little trinkets and decorations on the top level of the shelf including a potted plant and a ceramic pig. There is a girl sitting behind the desk.

>x pig
You see nothing special about Ceramic Pig.

>x potted plant
A leafy addition to the room. The plant is growing well.

>take pig
You ask if you can take the Ceramic Pig, but the girl at the desk says "Of course not. That's my bus money. I need a dollar to take the bus, and those quarter's are gonna get me home. If you can give me a dollar bill or something, then you can take it." You recall that you left your wallet inside the car.

>s
Office
The teachers don't really need to grade anything, so only the administration workers need cubicles. There are only four cubicles, two on each side of the walk way at the center. As you scan the room, a woman walks past. Her nametag reads "Miss Graham: Headmaster". To the North is the Parent Waiting Room. To the West is the Lounge. To the South is the Classroom.

>n
Parent Waiting Room
The room is a modestly sized rectangular room. Lining the pastel yellow walls are wooden armchairs. Against the north wall is the reception desk. There is a girl sitting behind the desk. To the West is the Parking Lot. To the South is the Office.

>w
Parking Lot
A large parking lot. There aren't a lot of cars in the lot right now, but a couple hours later and it'll be jam packed. Your car is parked in front of you. To the East is the Parent Waiting Room.

>x car
A brown toyota. You beam at its presence in the faculty parking. Welcome home, car.

>open cart
You can't see any such thing.

>open car
You open Car, revealing Wallet.

>take wallet
Taken.

>e
Parent Waiting Room
The room is a modestly sized rectangular room. Lining the pastel yellow walls are wooden armchairs. Against the north wall is the reception desk. There is a girl sitting behind the desk. To the West is the Parking Lot. To the South is the Office.

>open wallet
You open Wallet, revealing Dollar Bill.

>take bill
Taken.

>give girl bill
You hand her the Dollar Bill, and she nods her head to the Ceramic Pig. You can take four quarters." You take the Ceramic Pig, and pull the rubber stopper from under it. Gently shaking the Ceramic Pig, four quarters fall into your palm. You put the Ceramic Pig back, and thank the girl.

>l
Parent Waiting Room
The room is a modestly sized rectangular room. Lining the pastel yellow walls are wooden armchairs. Against the north wall is the reception desk. There is a girl sitting behind the desk. To the West is the Parking Lot. To the South is the Office.

* * *

>s
Classroom
A somewhat large room, walls covered in posters. The floor is cluttered with toys and furniture. Small children run around, screaming at each other. Some of the younger children sit dumbly on a brightly colored rug, chewing on some poor plastic toy. There is a large window on the west wall, overlooking the playground. Along the four walls are cubby holes and shelves. The Office is to the North, and the Playground is to the West. Mrs. Green, the teacher, stands by the window, consoling a crying child.

>give george quarter
You can't see any such thing.

>i
You are carrying:
  Quarters
  Wallet (open but empty)

>x george
You see nothing special about George.

>s
You can't go that way.

>e
You can't go that way.

>l
Classroom
A somewhat large room, walls covered in posters. The floor is cluttered with toys and furniture. Small children run around, screaming at each other. Some of the younger children sit dumbly on a brightly colored rug, chewing on some poor plastic toy. There is a large window on the west wall, overlooking the playground. Along the four walls are cubby holes and shelves. The Office is to the North, and the Playground is to the West. Mrs. Green, the teacher, stands by the window, consoling a crying child.

>w
Playground
An open grassy space for the children to play in. There is a small plastic jungle gym at the center of the space for the older kids to play in. Next to it is a large wooden sandbox. Scattered around the grass is are jump ropes, balls, and a plastic toy cart.

>e
Classroom
A somewhat large room, walls covered in posters. The floor is cluttered with toys and furniture. Small children run around, screaming at each other. Some of the younger children sit dumbly on a brightly colored rug, chewing on some poor plastic toy. There is a large window on the west wall, overlooking the playground. Along the four walls are cubby holes and shelves. The Office is to the North, and the Playground is to the West. Mrs. Green, the teacher, stands by the window, consoling a crying child.

>talk to george
You ask George what's wrong. He wails, "B-blanky is gone." Blanky? What's that? Ask him about it.

>ask george about blanky
"Soft blanky. Is blue, and soft. I want it!" You ask him where he saw it last, to which he replies "Playground! I ride car and put it on my head. It fall down and I losed it. Then the car broke."

>w
Playground
An open grassy space for the children to play in. There is a small plastic jungle gym at the center of the space for the older kids to play in. Next to it is a large wooden sandbox. Scattered around the grass is are jump ropes, balls, and a plastic toy cart.

>x cart
Red body, yellow roof. The Cozy Coupe: a classic. You push the cart a little bit, and discover one of the wheels don't move.

>x wheel
Black plastic wheel attached to the cart.

>x broken wheel
You can't see any such thing.

>x stuck wheel
You can't see any such thing.

>take brown rag
Taken.

>x brown rag
On closer inspection, you realize that the blanket is soaked with mud from the grass. It must be George's soft blue Blanky! You can't give it back to George like this! There must be a way to fix this... maybe Miss Graham can help.

>l
Playground
An open grassy space for the children to play in. There is a small plastic jungle gym at the center of the space for the older kids to play in. Next to it is a large wooden sandbox. Scattered around the grass is are jump ropes, balls, and a plastic toy cart.

>e
Classroom
A somewhat large room, walls covered in posters. The floor is cluttered with toys and furniture. Small children run around, screaming at each other. Some of the younger children sit dumbly on a brightly colored rug, chewing on some poor plastic toy. There is a large window on the west wall, overlooking the playground. Along the four walls are cubby holes and shelves. The Office is to the North, and the Playground is to the West. Mrs. Green, the teacher, stands by the window, consoling a crying child.

>n
Office
The teachers don't really need to grade anything, so only the administration workers need cubicles. There are only four cubicles, two on each side of the walk way at the center. As you scan the room, a woman walks past. Her nametag reads "Miss Graham: Headmaster". To the North is the Parent Waiting Room. To the West is the Lounge. To the South is the Classroom.

>ask miss graham about brown rag
You show her the brown rag and explain the situation. She laughs and says, "Don't worry. There's a washer-dryer machine in the faculty lounge. You can wash the blanket there.

>l
Office
The teachers don't really need to grade anything, so only the administration workers need cubicles. There are only four cubicles, two on each side of the walk way at the center. As you scan the room, a woman walks past. Her nametag reads "Miss Graham: Headmaster". To the North is the Parent Waiting Room. To the West is the Lounge. To the South is the Classroom.

>w
Lounge
There is a microwave and a sink at the counter, below which are a couple of drawers. At the center of the room is a round table. Because this is a preschool, there is also a washer-dryer machine in the far corner.

>put brown rag in washer
You can't see any such thing.

>put brown rag in machine
Washer-Dryer Machine is closed.

>open machine
It seems to be locked.

>l
Lounge
There is a microwave and a sink at the counter, below which are a couple of drawers. At the center of the room is a round table. Because this is a preschool, there is also a washer-dryer machine in the far corner.

>x drawers
You can't see any such thing.

>open drawers
You can't see any such thing.

>x table
The faculty usually eat lunch on this table. "Though, they don't do a very good job of cleaning it up" you think to yourself as you examine a blob of ketchup on the surface. There's a bowl at the center of the table.

>x bowl
The bowl should have quarters for the Washer-Dryer machine, but it's empty! "It must've been that girl at the front desk! I saw a ceramic pig thing on the reception desk...! There must be coins in there." you think to yourself.

>i
You are carrying:
  Brown Rag
  Quarters
  Wallet (open but empty)

>x machine
A combination of both, this is a practical necessity for a preschool! The only problem is you need to insert quarters into the machine to unlock the machine. There should be a bowl full of quarters on the table.

>put quarters into machine
Washer-Dryer Machine is closed.

>open machine
It seems to be locked.

>i
You are carrying:
  Brown Rag
  Quarters
  Wallet (open but empty)

>unlock machine with quarters
You unlock Washer-Dryer Machine.

>open machine
You open Washer-Dryer Machine.

>put brown rag in machine
You put Brown Rag into Washer-Dryer Machine.

You adjust the options to "Speed Wash" and press the Power Button. The washer-dryer whirs to life, and you wait 15 minutes before a beeping sound blares from the machine. You take out George's blanket, now soft and fresh (and blue), and smile.

    *** You proudly hand the blanket to George. You're about to reprimand "Do you know the trouble I went through to get that, Mister?" when George squeals in delight. You can't help but laugh. You decide to keep that thought to yourself because George doesn't need to know that. ***

Would you like to RESTART, RESTORE a saved game, QUIT or UNDO the last command?

* * *

>x reception desk
The desk is very large, taking up almost half of the wall. There are a number of little trinkets and decorations including a potted plant and a ceramic pig. There is a girl sitting behind the desk.

>talk to the girl
She looks up briefly, then back down to her phone. She nonchalantly says, "You're with Miss Green. To get to her classroom, you'll have to go through the office."

>s
Office
The teachers don't really need to grade anything, so only the administration workers need cubicles. There are only four cubicles, two on each side of the walk way at the center. As you scan the room, a woman walks past. Her nametag reads "Miss Graham: Headmaster". To the North is the Parent Waiting Room. To the West is the Lounge. To the South is the Classroom.

>s
Classroom
A somewhat large room, walls covered in posters. The floor is cluttered with toys and furniture. Small children run around, screaming at each other. Some of the younger children sit dumbly on a brightly colored rug, chewing on some poor plastic toy. There is a large window on the west wall, overlooking the playground. Along the four walls are cubby holes. The Office is to the North, and the Playground is to the West. Mrs. Green, the teacher, stands by the window, consoling a crying child.

>w
Playground
An open grassy space for the children to play in. There is a small plastic jungle gym at the center of the space for the older kids to play in. Next to it is a large wooden sandbox. Scattered around the grass are jump ropes, balls, and a plastic toy cart. Sounds of giggling children come from the Classroom, to the East.

>e
Classroom
A somewhat large room, walls covered in posters. The floor is cluttered with toys and furniture. Small children run around, screaming at each other. Some of the younger children sit dumbly on a brightly colored rug, chewing on some poor plastic toy. There is a large window on the west wall, overlooking the playground. Along the four walls are cubby holes. The Office is to the North, and the Playground is to the West. Mrs. Green, the teacher, stands by the window, consoling a crying child.

>w
Playground
An open grassy space for the children to play in. There is a small plastic jungle gym at the center of the space for the older kids to play in. Next to it is a large wooden sandbox. Scattered around the grass are jump ropes, balls, and a plastic toy cart. Sounds of giggling children come from the Classroom, to the East.

>s
You can't go that way.

>e
Classroom
A somewhat large room, walls covered in posters. The floor is cluttered with toys and furniture. Small children run around, screaming at each other. Some of the younger children sit dumbly on a brightly colored rug, chewing on some poor plastic toy. There is a large window on the west wall, overlooking the playground. Along the four walls are cubby holes. The Office is to the North, and the Playground is to the West. Mrs. Green, the teacher, stands by the window, consoling a crying child.

>n
Office
The teachers don't really need to grade anything, so only the administration workers need cubicles. There are only four cubicles, two on each side of the walk way at the center. As you scan the room, a woman walks past. Her nametag reads "Miss Graham: Headmaster". To the North is the Parent Waiting Room. To the West is the Lounge. To the South is the Classroom.

>s
Classroom
A somewhat large room, walls covered in posters. The floor is cluttered with toys and furniture. Small children run around, screaming at each other. Some of the younger children sit dumbly on a brightly colored rug, chewing on some poor plastic toy. There is a large window on the west wall, overlooking the playground. Along the four walls are cubby holes. The Office is to the North, and the Playground is to the West. Mrs. Green, the teacher, stands by the window, consoling a crying child.

>talk to miss green
You can't see any such thing.

>talk to mrs. green
You walk up to Mrs. Green, and say "Hello.". She sighs in relief and says, "Thank the Lord that you're here! This is George," she says, gesturing to the crying child. "Right now, I need you to get him to stop crying. I really need to get the kids in order, and a wailing child does not help!" George, a small boy, looks to you as Mrs. Green hurries away to settle another dispute.

That's not a verb I recognise.

>george
That's not a verb I recognise.

>talk to george
You ask George what's wrong. He wails, "B-blanky is gone." Blanky? What's that? Ask him about it.

>ask george about blanky
"Soft blanky. Is blue, and soft. I want it!" You ask him where he saw it last, to which he replies "Playground! Morning recess I ride car and put it on my head. It fall down and I losed it. Then the car broke."

>l
Classroom
A somewhat large room, walls covered in posters. The floor is cluttered with toys and furniture. Small children run around, screaming at each other. Some of the younger children sit dumbly on a brightly colored rug, chewing on some poor plastic toy. There is a large window on the west wall, overlooking the playground. Along the four walls are cubby holes. The Office is to the North, and the Playground is to the West. Mrs. Green, the teacher, stands by the window, consoling a crying child.

>w
Playground
An open grassy space for the children to play in. There is a small plastic jungle gym at the center of the space for the older kids to play in. Next to it is a large wooden sandbox. Scattered around the grass are jump ropes, balls, and a plastic toy cart. Sounds of giggling children come from the Classroom, to the East.

>jungle gym
That's not a verb I recognise.

>x jungle gym
No playground is complete without one of these jungle gyms. Designed for children, the complex includes a slide, a roof, a small ladder, and a tic-tac-toe game. You used to play on these as a child, and long for the simplistic days of 10:30 recesses.

>x sandbox
A center for aspiring-architect toddlers to built their dream, er, mound.

>x jump ropes
Double dutch was never your thing. Your hand-eye coordination just goes out the window as soon as you grip those plastic handles.

I beg your pardon?

>x plastic to cart
You can't see any such thing.

>x plastic toy cart
Red body, yellow roof. The Cozy Coupe: a classic. You push the cart a little bit, and discover one of the wheels don't move.

>x wheels
You can't see any such thing.

>x wheel
Black plastic wheel attached to the cart. Wheel is detachable.

>take off wheel
You aren't wearing Wheel.

>take wheel
Looks like there's a Brown Rag inside the hollow of the wheel.

>x brown bag
I only understood you as far as wanting to examine Brown Rag.

>x brown rag
On closer inspection, you realize that the Brown Rag is a blanket soaked with mud. It must be George's soft blue Blanky! You can't give it back to George like this! There must be a way to fix this... maybe Miss Graham can help.

>take blue blanky
You can't see any such thing.

>take blue blankey
You can't see any such thing.

>take soft blue blankey
You can't see any such thing.

>take brown rag
Taken.

>talk to miss graham
You can't see any such thing.

>n
You can't go that way.

>e
Classroom
A somewhat large room, walls covered in posters. The floor is cluttered with toys and furniture. Small children run around, screaming at each other. Some of the younger children sit dumbly on a brightly colored rug, chewing on some poor plastic toy. There is a large window on the west wall, overlooking the playground. Along the four walls are cubby holes. The Office is to the North, and the Playground is to the West. Mrs. Green, the teacher, stands by the window, consoling a crying child.

* * *

>n
Office
The teachers don't really need to grade anything, so only the administration workers need cubicles. There are only four cubicles, two on each side of the walk way at the center. As you scan the room, a woman walks past. Her nametag reads "Miss Graham: Headmaster". To the North is the Parent Waiting Room. To the West is the Lounge. To the South is the Classroom.

>talk to miss graham
You approach Miss Graham, and she turns to you. She smiles and says "Hello, Miss White. I hope your first day is going well. If you have any problems or questions, please feel free to ask me."

>ask to wash brown rag
You can't see any such thing.

>ask miss graham about brown rag
You show her the brown rag and explain the situation. She laughs and says, "Don't worry. There's a washer-dryer machine in the faculty lounge. You can wash the blanket there.

>w
Lounge
There is a microwave and a sink at the counter. At the center of the room is a round table. Because this is a preschool, there is also a washer-dryer machine in the far corner. To the East is the Office.

>far corner
That's not a verb I recognise.

>wash brown rag
That's not a verb I recognise.

>x brown rag
On closer inspection, you realize that the Brown Rag is a blanket soaked with mud. It must be George's soft blue Blanky! You can't give it back to George like this! There must be a way to fix this... maybe Miss Graham can help.

>x washer-dryer machine
A combination of both, this is a practical necessity for a preschool! The only problem is you need to insert quarters into the machine to UNLOCK the lid in order to open the machine. There should be a bowl full of quarters on the table.

>take quarter
You can't see any such thing.

>x table
The faculty usually eat lunch on this table. "Though, they don't do a very good job of cleaning it up" you think to yourself as you examine a blob of ketchup on the surface. There's a bowl at the center of the table.

* * *

>x bowl
The bowl should have quarters for the Washer-Dryer machine, but it's empty! "It must've been that girl at the front desk! I saw a ceramic pig thing on the reception desk...! There must be coins in there." you think to yourself.

>e
Office
The teachers don't really need to grade anything, so only the administration workers need cubicles. There are only four cubicles, two on each side of the walk way at the center. As you scan the room, a woman walks past. Her nametag reads "Miss Graham: Headmaster". To the North is the Parent Waiting Room. To the West is the Lounge. To the South is the Classroom.

>w
Lounge
There is a microwave and a sink at the counter. At the center of the room is a round table. Because this is a preschool, there is also a washer-dryer machine in the far corner. To the East is the Office.

>e
Office
The teachers don't really need to grade anything, so only the administration workers need cubicles. There are only four cubicles, two on each side of the walk way at the center. As you scan the room, a woman walks past. Her nametag reads "Miss Graham: Headmaster". To the North is the Parent Waiting Room. To the West is the Lounge. To the South is the Classroom.

>e
You can't go that way.

>s
Classroom
A somewhat large room, walls covered in posters. The floor is cluttered with toys and furniture. Small children run around, screaming at each other. Some of the younger children sit dumbly on a brightly colored rug, chewing on some poor plastic toy. There is a large window on the west wall, overlooking the playground. Along the four walls are cubby holes. The Office is to the North, and the Playground is to the West. Mrs. Green, the teacher, stands by the window, consoling a crying child.

>n
Office
The teachers don't really need to grade anything, so only the administration workers need cubicles. There are only four cubicles, two on each side of the walk way at the center. As you scan the room, a woman walks past. Her nametag reads "Miss Graham: Headmaster". To the North is the Parent Waiting Room. To the West is the Lounge. To the South is the Classroom.

>n
Parent Waiting Room
The room is a modestly sized rectangular room. Lining the pastel yellow walls are wooden armchairs. Against the north wall is the reception desk. There is a girl sitting behind the desk. To the West is the Parking Lot. To the South is the Office.

>n
You can't go that way.

>x reception desk
The desk is very large, taking up almost half of the wall. There are a number of little trinkets and decorations including a potted plant and a ceramic pig. There is a girl sitting behind the desk.

>x ceramic oig
I only understood you as far as wanting to examine Ceramic Pig.

>x ceramic pig
A small pig ceramic pig that fits nicely into the palm of your hand. When you shake it, a loud clinking sounds the room.

>take coin
You can't see any such thing.

>smash cerami pig
You can't see any such thing.

>talk to girl
She looks up briefly, then back down to her phone. She nonchalantly says, "You're with Miss Green. To get to her classroom, you'll have to go through the office."

>take ceramic pig
You ask if you can take the Ceramic Pig, but the girl at the desk says "Of course not. That's my bus money. I need a dollar to take the bus, and those quarter's are gonna get me home. If you can give me a dollar bill or something, then you can take it." You recall that you left your wallet inside the car.

>go to car
You can't see any such thing.

>go to parking lot
You can't see any such thing.

>exit
But you aren't in anything at the moment.

>l
Parent Waiting Room
The room is a modestly sized rectangular room. Lining the pastel yellow walls are wooden armchairs. Against the north wall is the reception desk. There is a girl sitting behind the desk. To the West is the Parking Lot. To the South is the Office.

>w
Parking Lot
A large parking lot. There aren't a lot of cars in the lot right now, but a couple hours later and it'll be jam packed. Your car is parked in front of you. To the East is the Parent Waiting Room.

>go to car
You can't see any such thing.

>x car
A brown toyota. You beam at its presence in the faculty parking. Welcome home, car.

>open car
You open Car, revealing Wallet.

>steal walle
That's not a verb I recognise.

>take wallet
Taken.

* * *

>e
Parent Waiting Room
The room is a modestly sized rectangular room. Lining the pastel yellow walls are wooden armchairs. Against the north wall is the reception desk. There is a girl sitting behind the desk. To the West is the Parking Lot. To the South is the Office.

>n
You can't go that way.

* * *

>x reception desk
The desk is very large, taking up almost half of the wall. There are a number of little trinkets and decorations including a potted plant and a ceramic pig. There is a girl sitting behind the desk.

>x ceramic pig
A small pig ceramic pig that fits nicely into the palm of your hand. When you shake it, a loud clinking sounds the room.

>take ceramic pig
You ask if you can take the Ceramic Pig, but the girl at the desk says "Of course not. That's my bus money. I need a dollar to take the bus, and those quarter's are gonna get me home. If you can give me a dollar bill or something, then you can take it." You recall that you left your wallet inside the car.

>give dollar to girl
You can't see any such thing.

>open wallet
You open Wallet, revealing Dollar Bill.

>give dollar to girl
(first taking Dollar Bill)
You hand her the Dollar Bill, and she nods her head to the Ceramic Pig. "You can take four quarters." You take the Ceramic Pig, and pull the rubber stopper from under it. Gently shaking the Ceramic Pig, four quarters fall into your palm. You put the Ceramic Pig back, and thank the girl.

>i
You are carrying:
  Quarters
  Wallet (open but empty)
  Brown Rag
  Wheel

>throw away wheel
You can't see any such thing.

>drop wheel
Dropped.

>go to lounge
You can't see any such thing.

>l
Parent Waiting Room
The room is a modestly sized rectangular room. Lining the pastel yellow walls are wooden armchairs. Against the north wall is the reception desk. There is a girl sitting behind the desk. To the West is the Parking Lot. To the South is the Office.

You can see Wheel (empty) here.

>s
Office
The teachers don't really need to grade anything, so only the administration workers need cubicles. There are only four cubicles, two on each side of the walk way at the center. As you scan the room, a woman walks past. Her nametag reads "Miss Graham: Headmaster". To the North is the Parent Waiting Room. To the West is the Lounge. To the South is the Classroom.

>w
Lounge
There is a microwave and a sink at the counter. At the center of the room is a round table. Because this is a preschool, there is also a washer-dryer machine in the far corner. To the East is the Office.

>x machine
A combination of both, this is a practical necessity for a preschool! The only problem is you need to insert quarters into the machine to UNLOCK the lid in order to open the machine. There should be a bowl full of quarters on the table.

>UNLOCK
What do you want to unlock?

>machine
What do you want to unlock Washer-Dryer Machine with?

>dollar
You can't see any such thing.

>quarter
That's not a verb I recognise.

>UNLOCK machine with quarters
You unlock Washer-Dryer Machine.

>oh ya
That's not a verb I recognise.

>throw brown rag inside machine
I only understood you as far as wanting to throw Brown Rag.

>place brown rag in machine
That's not a verb I recognise.

>put brown rag in machne
You can't see any such thing.

>put brown rag in machine
Washer-Dryer Machine is closed.

>shit
That's not a verb I recognise.

>open machine
You open Washer-Dryer Machine.

>put rag in machine
You put Brown Rag into Washer-Dryer Machine.

You adjust the options to "Speed Wash" and press the Power Button. The washer-dryer whirs to life, and you wait 15 minutes before a beeping sound blares from the machine. You take out George's blanket, now soft and fresh (and blue), and smile.

    *** You proudly hand the blanket to George. You're about to reprimand "Do you know the trouble I went through to get that, Mister?" when George squeals in delight. You can't help but laugh. You decide to keep that thought to yourself because George doesn't need to know that. ***

Would you like to RESTART, RESTORE a saved game, QUIT or UNDO the last command?

* * *

>x reception desk
The desk is very large, taking up almost half of the wall. There are a number of little trinkets and decorations including a potted plant and a ceramic pig. There is a girl sitting behind the desk.

>talk to girl
She looks up briefly, then back down to her phone. She nonchalantly says "You're with Miss Green. To get to her classroom, you'll have to go through the office.

* * *

>speak to girl
I didn't understand that sentence.

>talk to girl
She looks up briefly, then back down to her phone. She nonchalantly says, "You're with Miss Green. To get to her classroom, you'll have to go through the office.

>talk to girl
She looks up briefly, then back down to her phone. She nonchalantly says, "You're with Miss Green. To get to her classroom, you'll have to go through the office.

>s
Office
The teachers don't really need to grade anything, so only the administration workers need cubicles. There are only four cubicles, two on each side of the walk way at the center. To the North is the Parent Waiting Room. To the West is the Lounge. To the South is the Classroom.

>s
Classroom
A somewhat large room, walls covered in posters. The floor is cluttered with toys and furniture. Small children run around, screaming at each other. Some of the younger children sit dumbly on a brightly colored rug, chewing on some poor plastic toy. There is a large window on the west wall, overlooking the playground. Along the four walls are cubby holes and shelves. The Office is to the North, and the Playground is to the West. Mrs. Green, the teacher, stands by the window, consoling a crying child.

>talk to mrs. green
You walk up to Mrs. Green and introduce yourself. "Thank the Lord that you're here! This is George," she says, gesturing to the crying child. "Right now, I need you to get him to stop crying. I really need to get the kids in order, and a wailing child does not help!" George, a small boy, looks to you as Mrs. Green hurries away to settle another dispute.

That's not a verb I recognise.

>talk to george
You ask George what's wrong. He wails, "B-blanky is gone." Blanky? What's that? Ask him about it.

* * *

>ask george about blanky
"Soft blanky. Is blue, and soft. I want it!" You ask him where he saw it last, to which he replies "Playground! I ride car and put it on my head. It fall down and I losed it. Then the car broke."

>ask george to stop crying
I didn't understand that sentence.

>w
Playground
An open grassy space for the children to play in. There is a small plastic jungle gym at the center of the space for the older kids to play in. Next to it is a large wooden sandbox. Scattered around the grass is are jump ropes, balls, and a plastic toy cart.

>x plastic toy cart
Red body, yellow roof. The Cozy Coupe: a classic. You push the cart a little bit, and discover one of the wheels don't move.

* * *

>x wheels
You can't see any such thing.

>x wheel
Caught between the black plastic wheel and the metal hook is a brown rag.

>take brown rag
Taken.

>x brown rag
On closer inspection, you realize that the blanket is soaked with mud from the grass. It must be George's soft blue Blanky! You can't give it back to George like this! There must be a way to fix this... maybe Mrs. Green can help.

>e
Classroom
A somewhat large room, walls covered in posters. The floor is cluttered with toys and furniture. Small children run around, screaming at each other. Some of the younger children sit dumbly on a brightly colored rug, chewing on some poor plastic toy. There is a large window on the west wall, overlooking the playground. Along the four walls are cubby holes and shelves. The Office is to the North, and the Playground is to the West. Mrs. Green, the teacher, stands by the window, consoling a crying child.

>ask mrs. green about blanky
I didn't understand that sentence.

>ask mrs. green about blanket
I didn't understand that sentence.

I beg your pardon?

>ask mrs. green about brown rag
I didn't understand that sentence.

I beg your pardon?

* * *

>ask mrs. green about blanket
I didn't understand that sentence.

>ask mrs. green about brown rag
I didn't understand that sentence.

* * *

>x armchair
Wooden armchairs. Parents usually sit on the chairs as they wait for their kids. It's a way to get them to calm down after a hectic day of work.

>w
Parking Lot
A large parking lot. There aren't a lot of cars in the lot right now, but a couple hours later and it'll be jam packed. Your car is parked in front of you. To the East is the Parent Waiting Room.

>e
Parent Waiting Room
The room is a modestly sized rectangular room. Lining the pastel yellow walls are wooden armchairs. Against the north wall is the reception desk. There is a girl sitting behind the desk. To the West is the Parking Lot. To the South is the Office.

>s
Office
The teachers don't really need to grade anything, so only the administration workers need cubicles. There are only four cubicles, two on each side of the walk way at the center. As you scan the room, a woman walks past. Her nametag reads "Miss Graham: Headmaster". To the North is the Parent Waiting Room. To the West is the Lounge. To the South is the Classroom.

* * *

>n
Parent Waiting Room
The room is a modestly sized rectangular room. Lining the pastel yellow walls are wooden armchairs. Against the north wall is the reception desk. There is a girl sitting behind the desk. To the West is the Parking Lot. To the South is the Office.

>talk girl
I didn't understand that sentence.

>x girl
She is sitting behind the desk, furiously texting into her phone. She doesn't even notice that you've walked up to her.

>s
Office
The teachers don't really need to grade anything, so only the administration workers need cubicles. There are only four cubicles, two on each side of the walk way at the center. As you scan the room, a woman walks past. Her nametag reads "Miss Graham: Headmaster". To the North is the Parent Waiting Room. To the West is the Lounge. To the South is the Classroom.

* * *

>e
Office
The teachers don't really need to grade anything, so only the administration workers need cubicles. There are only four cubicles, two on each side of the walk way at the center. As you scan the room, a woman walks past. Her nametag reads "Miss Graham: Headmaster". To the North is the Parent Waiting Room. To the West is the Lounge. To the South is the Classroom.

>n
Parent Waiting Room
The room is a modestly sized rectangular room. Lining the pastel yellow walls are wooden armchairs. Against the north wall is the reception desk. There is a girl sitting behind the desk. To the West is the Parking Lot. To the South is the Office.

>talk to girl
She looks up briefly, then back down to her phone. She nonchalantly says, "You're with Miss Green. To get to her classroom, you'll have to go through the office."

>s
Office
The teachers don't really need to grade anything, so only the administration workers need cubicles. There are only four cubicles, two on each side of the walk way at the center. As you scan the room, a woman walks past. Her nametag reads "Miss Graham: Headmaster". To the North is the Parent Waiting Room. To the West is the Lounge. To the South is the Classroom.

* * *

>e
Office
The teachers don't really need to grade anything, so only the administration workers need cubicles. There are only four cubicles, two on each side of the walk way at the center. As you scan the room, a woman walks past. Her nametag reads "Miss Graham: Headmaster". To the North is the Parent Waiting Room. To the West is the Lounge. To the South is the Classroom.

>s
Classroom
A somewhat large room, walls covered in posters. The floor is cluttered with toys and furniture. Small children run around, screaming at each other. Some of the younger children sit dumbly on a brightly colored rug, chewing on some poor plastic toy. There is a large window on the west wall, overlooking the playground. Along the four walls are cubby holes. The Office is to the North, and the Playground is to the West. Miss Green, the teacher, stands by the window, consoling a crying child.

>talk to mrs. green
You can't see any such thing.

>talk to miss green
You walk up to Miss Green, and say "Hello." She sighs in relief and says, "Thank the Lord that you're here! This is George," she says, gesturing to the crying child. "Right now, I need you to get him to stop crying. I really need to get the kids in order, and a wailing child does not help!" George, a small boy, looks to you as Miss Green hurries away to settle another dispute.

>talk to george
You ask George what's wrong. He wails, "B-blanky is gone." Blanky? What's that? Ask him about it.

>ask george about blanky
"Soft blanky. Is blue, and soft. I want it!" You ask him where he saw it last, to which he replies "Playground! Morning recess I ride cart and put it on my head. It fall down and I losed it. Then the cart broke."

>w
Playground
An open grassy space for the children to play in. There is a small plastic jungle gym at the center of the space for the older kids to play in. Next to it is a large wooden sandbox. Scattered around the grass are jump ropes, balls, and a plastic toy cart. Sounds of giggling children come from the Classroom, to the East.

>take blanky
You can't see any such thing.

>x jungle gym
No playground is complete without one of these jungle gyms. Designed for children, the complex includes a slide, a small ladder, and a tic-tac-toe game. You used to play on these as a child, and long for the simplistic days of 10:30 recesses.

>x sandbox
A center for aspiring-architect toddlers to built their dream, er, mound.

>x car
You can't see any such thing.

>e
Classroom
A somewhat large room, walls covered in posters. The floor is cluttered with toys and furniture. Small children run around, screaming at each other. Some of the younger children sit dumbly on a brightly colored rug, chewing on some poor plastic toy. There is a large window on the west wall, overlooking the playground. Along the four walls are cubby holes. The Office is to the North, and the Playground is to the West. Miss Green, the teacher, stands by the window, consoling a crying child.

* * *

>open car
You open Car, revealing Wallet.

>open wallet
You open Wallet, revealing Dollar Bill.

* * *

>e
Parent Waiting Room
The room is a modestly sized rectangular room. Lining the pastel yellow walls are wooden armchairs. In the center of the room, there is a glass coffee table. On it is a neatly stacked pile of magazines. Next to the glass door is a water dispenser machine, with cups on top. Against the north wall is the Reception Desk. Somebody is sitting behind the desk. To the West is the Parking Lot. To the South is the Office.

>s
Office
The teachers don't really need to grade anything, so only the administration workers need cubicles. There are only four cubicles, two on each side of the walk way at the center. To the West is the Headmaster's Office. To the North is the Parent Waiting Room. To the South is the Playground.

>w
Headmaster's Office
The room is tidy and organized, albeit a little small. There is a shelf of books by one wall, and a sofa on the other. Potted plants hang in front of a large window, overlooking the Parking Lot. At the center of the room is a large wooden desk. There are stacks of papers and forms just waiting to be signed. Behind the desk is the Headmaster, Ms. Color.

>w
You can't go that way.

I beg your pardon?

>e
Office
The teachers don't really need to grade anything, so only the administration workers need cubicles. There are only four cubicles, two on each side of the walk way at the center. To the West is the Headmaster's Office. To the North is the Parent Waiting Room. To the South is the Playground.

>w
Headmaster's Office
The room is tidy and organized, albeit a little small. There is a shelf of books by one wall, and a sofa on the other. Potted plants hang in front of a large window, overlooking the Parking Lot. At the center of the room is a large wooden desk. There are stacks of papers and forms just waiting to be signed. Behind the desk is the Headmaster, Ms. Color.

>e
Office
The teachers don't really need to grade anything, so only the administration workers need cubicles. There are only four cubicles, two on each side of the walk way at the center. To the West is the Headmaster's Office. To the North is the Parent Waiting Room. To the South is the Playground.

* * *

>n
You can't go that way.

>talk to girl
She looks up briefly, then back down to her phone. She nonchalantly says, "You're with Miss Green. To get to her classroom, you'll have to go through the office."

>x
(Key)
You see nothing special about Key.

>i
You are carrying:
  Key

>x room
You can't see any such thing.

>look
Parent Waiting Room
The room is a modestly sized rectangular room. Lining the pastel yellow walls are wooden armchairs. Against the north wall is the reception desk. There is a girl sitting behind the desk. To the West is the Parking Lot. To the South is the Office.

>s
Office
The teachers don't really need to grade anything, so only the administration workers need cubicles. There are only four cubicles, two on each side of the walk way at the center. As you scan the room, a woman walks past. Her nametag reads "Miss Graham: Headmaster". To the North is the Parent Waiting Room. To the West is the Lounge. To the South is the Classroom.

* * *

>w
Lounge
There is a microwave and a sink at the counter. At the center of the room is a round table. Because this is a preschool, there is also a washer-dryer machine in the far corner. To the East is the Office.

>x table
The faculty usually eat lunch on this table. "Though, they don't do a very good job of cleaning it up" you think to yourself as you examine a blob of ketchup on the surface. There's a bowl at the center of the table.

>x bowl
The bowl should have quarters for the Washer-Dryer machine, but it's empty! "I saw a ceramic pig thing on the reception desk... that girl must've stolen all the coins from the bowl for herself!" you think to yourself.

>x sink
Just your average Grade A stainless steel sink.

>x washer
You can't see any such thing.

>x washer-dryer
The MACHINE is combination of both washing machine and drying machine, a practical necessity for a preschool! The only problem is you need to insert quarters into the machine to UNLOCK the lid in order to open the machine. There should be a bowl full of quarters on the table.

>e
Office
The teachers don't really need to grade anything, so only the administration workers need cubicles. There are only four cubicles, two on each side of the walk way at the center. As you scan the room, a woman walks past. Her nametag reads "Miss Graham: Headmaster". To the North is the Parent Waiting Room. To the West is the Lounge. To the South is the Classroom.

* * *

>n
Parent Waiting Room
The room is a modestly sized rectangular room. Lining the pastel yellow walls are wooden armchairs. Against the north wall is the reception desk. There is a girl sitting behind the desk. To the West is the Parking Lot. To the South is the Office.

>x girl
She is sitting behind the desk, furiously texting into her phone. She doesn't even notice that you've walked up to her.

>x desk
The desk is very large, taking up almost half of the wall. There are a number of little trinkets and decorations including a potted plant and a ceramic pig. There is a girl sitting behind the desk.

>x pig
A small pig ceramic pig that fits nicely into the palm of your hand. When you shake it, a loud clinking sounds the room.

>take pig
You ask if you can take the Ceramic Pig, but the girl at the desk says "Of course not. That's my bus money. I need a dollar to take the bus, and those quarter's are gonna get me home. If you can give me a dollar bill or something, then you can take it." You recall that you left your wallet inside the car.

* * *

>n
You can't go that way.

>w
Parking Lot
A large parking lot. There aren't a lot of cars in the lot right now, but a couple hours later and it'll be jam packed. Your car is parked in front of you. To the East is the Parent Waiting Room.

>x car
A brown toyota. The key to the car is safely in your pocket. You beam at its presence in the faculty parking.

>open car
It seems to be locked.

>use key
That's not a verb I recognise.

>unlock car
(with Key)
You unlock Car.

>open car
After pulling the door open, you stick your head into car. After rummaging around, you find your wallet lying under the carseat.

* * *

>take wallet
Taken.

>lock car
What do you want to lock Car with?

>use key
You can't see any such thing.

>lock car with key
First you would have to close Car.

>close car
You close Car.

>lock car with key
You lock Car.

>w
You can't go that way.

>s
You can't go that way.

>e
Parent Waiting Room
The room is a modestly sized rectangular room. Lining the pastel yellow walls are wooden armchairs. Against the north wall is the reception desk. There is a girl sitting behind the desk. To the West is the Parking Lot. To the South is the Office.

>x wallet
A small white leather wallet that you got as a graduation present.

>open walllet
You can't see any such thing.

>open wallet
You open the wallet, revealing a dollar bill, hastily shoved into the bill compartment.

>give girl a dollar
(first taking Dollar Bill)
You hand her the Dollar Bill, and she nods her head to the Ceramic Pig. "You can take four quarters." You take the Ceramic Pig, and pull the rubber stopper from under it. Gently shaking the Ceramic Pig, four quarters fall into your palm. You put the Ceramic Pig back, and thank the girl.

>x desk
The desk is very large, taking up almost half of the wall. There are a number of little trinkets and decorations including a potted plant and a ceramic pig. There is a girl sitting behind the desk.

>x plant
A leafy addition to the room. The plant is growing well.

>take plant
That's hardly portable.

>take girl
I don't suppose the girl would care for that.

>s
Office
The teachers don't really need to grade anything, so only the administration workers need cubicles. There are only four cubicles, two on each side of the walk way at the center. As you scan the room, a woman walks past. Her nametag reads "Miss Graham: Headmaster". To the North is the Parent Waiting Room. To the West is the Lounge. To the South is the Classroom.

>x cubicle
You can't see any such thing.

>x cubicles
These belong to the office administration workers. You shouldn't go in they're working pretty hard inside.

>take to adiministration workers
You can't see any such thing.

>talk to administration workers
You can't see any such thing.

>take to miss graham
You can't see any such thing.

>w
Lounge
There is a microwave and a sink at the counter. At the center of the room is a round table. Because this is a preschool, there is also a washer-dryer machine in the far corner. To the East is the Office.

>x washer-dryer
The MACHINE is combination of both washing machine and drying machine, a practical necessity for a preschool! The only problem is you need to insert quarters into the machine to UNLOCK the lid in order to open the machine. There should be a bowl full of quarters on the table.

* * *

>e
Office
The teachers don't really need to grade anything, so only the administration workers need cubicles. There are only four cubicles, two on each side of the walk way at the center. As you scan the room, a woman walks past. Her nametag reads "Miss Graham: Headmaster". To the North is the Parent Waiting Room. To the West is the Lounge. To the South is the Classroom.

>s
Classroom
A somewhat large room, walls covered in posters. The floor is cluttered with toys and furniture. Small children run around, screaming at each other. Some of the younger children sit dumbly on a brightly colored rug, chewing on some poor plastic toy. There is a large window on the west wall, overlooking the playground. Along the four walls are cubby holes. The Office is to the North, and the Playground is to the West. Mrs. Green, the teacher, stands by the window, consoling a crying child.

>x child
You can't see any such thing.

>talk mrs. green
I didn't understand that sentence.

>talk to mrs. green
You walk up to Mrs. Green, and say "Hello." She sighs in relief and says, "Thank the Lord that you're here! This is George," she says, gesturing to the crying child. "Right now, I need you to get him to stop crying. I really need to get the kids in order, and a wailing child does not help!" George, a small boy, looks to you as Mrs. Green hurries away to settle another dispute.

That's not a verb I recognise.

>x george
A small boy who's about 2 years of age. His hair is cut into a bowl, resting high above his eyebrows. He retains some baby fat, but compared to other children, he is a skinny boy.

>talk to george
You ask George what's wrong. He wails, "B-blanky is gone." Blanky? What's that? Ask him about it.

>ask about  blanky
You can't see any such thing.

>ask about blanky
You can't see any such thing.

>ask about Blanky
You can't see any such thing.

>talk to george about blanky
I only understood you as far as wanting to talk to George.

>ask him about it
There is no reply.

>ask about george's blanky
You can't see any such thing.

>ask about B-blanky
You can't see any such thing.

>talk to george
You ask George what's wrong. He wails, "B-blanky is gone." Blanky? What's that? Ask him about it.

>ask him about the blanky
There is no reply.

>ask him about what's gone
There is no reply.

>x
What do you want to examine?

>x blanky
You can't see any such thing.

>look
Classroom
A somewhat large room, walls covered in posters. The floor is cluttered with toys and furniture. Small children run around, screaming at each other. Some of the younger children sit dumbly on a brightly colored rug, chewing on some poor plastic toy. There is a large window on the west wall, overlooking the playground. Along the four walls are cubby holes. The Office is to the North, and the Playground is to the West. Mrs. Green, the teacher, stands by the window, consoling a crying child.

>search cubby
You find nothing of interest.

>talk to mrs green
You walk up to Mrs. Green, and say "Hello." She sighs in relief and says, "Thank the Lord that you're here! This is George," she says, gesturing to the crying child. "Right now, I need you to get him to stop crying. I really need to get the kids in order, and a wailing child does not help!" George, a small boy, looks to you as Mrs. Green hurries away to settle another dispute.

>s
You can't go that way.

* * *

>e
You can't go that way.

>w
Playground
An open grassy space for the children to play in. There is a small plastic jungle gym at the center of the space for the older kids to play in. Next to it is a large wooden sandbox. Scattered around the grass are jump ropes, balls, and a plastic toy cart. Sounds of giggling children come from the Classroom, to the East.

* * *

>w
Lounge
There is a microwave and a sink at the counter. At the center of the room is a round table. Because this is a preschool, there is also a washer-dryer machine in the far corner. To the East is the Office.

>open washer-dryer
It seems to be locked.

>unlock with washer-dryer with quarters
You can't see any such thing.

>unlock washer-dryer
What do you want to unlock Washer-Dryer Machine with?

>use quarters
You can't see any such thing.

>use quarter
That's not a verb I recognise.

>insert quarter
You can't see any such thing.

>x washer-dryer
The MACHINE is combination of both washing machine and drying machine, a practical necessity for a preschool! The only problem is you need to insert quarters into the machine to UNLOCK the lid in order to open the machine. There should be a bowl full of quarters on the table.

>insert quarter
You can't see any such thing.

>unlock lid with quarters
You can't see any such thing.

>unlock lid
You can't see any such thing.

>unlock washer-dryer
What do you want to unlock Washer-Dryer Machine with?

>unlock washer-dryer with quarters
You unlock Washer-Dryer Machine.

* * *

>open lid
You can't see any such thing.

>open machine
That's already open.

>x machine
The MACHINE is combination of both washing machine and drying machine, a practical necessity for a preschool! The only problem is you need to insert quarters into the machine to UNLOCK the lid in order to open the machine. There should be a bowl full of quarters on the table.

>look inside machine
Washer-Dryer Machine is empty.

>w
You can't go that way.

* * *

>s
You can't go that way.

>n
You can't go that way.

>e
Office
The teachers don't really need to grade anything, so only the administration workers need cubicles. There are only four cubicles, two on each side of the walk way at the center. As you scan the room, a woman walks past. Her nametag reads "Miss Graham: Headmaster". To the North is the Parent Waiting Room. To the West is the Lounge. To the South is the Classroom.

* * *

>s
Classroom
A somewhat large room, walls covered in posters. The floor is cluttered with toys and furniture. Small children run around, screaming at each other. Some of the younger children sit dumbly on a brightly colored rug, chewing on some poor plastic toy. There is a large window on the west wall, overlooking the playground. Along the four walls are cubby holes. The Office is to the North, and the Playground is to the West. Mrs. Green, the teacher, stands by the window, consoling a crying child.

>ask george about blanky
"Soft blanky. Is blue, and soft. I want it!" You ask him where he saw it last, to which he replies "Playground! Morning recess I ride car and put it on my head. It fall down and I losed it. Then the car broke."

>w
Playground
An open grassy space for the children to play in. There is a small plastic jungle gym at the center of the space for the older kids to play in. Next to it is a large wooden sandbox. Scattered around the grass are jump ropes, balls, and a plastic toy cart. Sounds of giggling children come from the Classroom, to the East.

>x jungle gym
No playground is complete without one of these jungle gyms. Designed for children, the complex includes a slide, a roof, a small ladder, and a tic-tac-toe game. You used to play on these as a child, and long for the simplistic days of 10:30 recesses.

>x cart
Red body, yellow roof. The Cozy Coupe: a classic. You push the cart a little bit, and discover one of the wheels don't move.

* * *

>x wheel
Black plastic wheel attached to the cart. Wheel is detachable.

>detach wheel
That's not a verb I recognise.

>x broken wheel
You can't see any such thing.

>x wheel
Black plastic wheel attached to the cart. Wheel is detachable.

>turn wheel
Nothing obvious happens.

>x wheels
You can't see any such thing.

>x immobile wheel
You can't see any such thing.

>take cart
Taken.

>take ladder
You can't see any such thing.

>push cart
Nothing obvious happens.

>take wheel
You unhook the wheel from the cart, and take off the wheel. Looks like there's a Brown Rag inside the hollow of the wheel.

>take rag
Taken.

>e
Classroom
A somewhat large room, walls covered in posters. The floor is cluttered with toys and furniture. Small children run around, screaming at each other. Some of the younger children sit dumbly on a brightly colored rug, chewing on some poor plastic toy. There is a large window on the west wall, overlooking the playground. Along the four walls are cubby holes. The Office is to the North, and the Playground is to the West. Mrs. Green, the teacher, stands by the window, consoling a crying child.

* * *

>w
Lounge
There is a microwave and a sink at the counter. At the center of the room is a round table. Because this is a preschool, there is also a washer-dryer machine in the far corner. To the East is the Office.

>open washer-dryer
That's already open.

>place rag in machine
That's not a verb I recognise.

>put rag in machine
You put Brown Rag into Washer-Dryer Machine.

You adjust the options to "Speed Wash" and press the Power Button. The washer-dryer whirs to life, and you wait 15 minutes before a beeping sound blares from the machine. You take out George's blanket, now soft and fresh (and blue).

>take blanket
You already have that.

>s
You can't go that way.

>w
You can't go that way.

* * *

>s
Classroom
A somewhat large room, walls covered in posters. The floor is cluttered with toys and furniture. Small children run around, screaming at each other. Some of the younger children sit dumbly on a brightly colored rug, chewing on some poor plastic toy. There is a large window on the west wall, overlooking the playground. Along the four walls are cubby holes. The Office is to the North, and the Playground is to the West. Mrs. Green, the teacher, stands by the window, consoling a crying child.

>give blanky to george
You can't see any such thing.

>talk to george
You ask George what's wrong. He wails, "B-blanky is gone." Blanky? What's that? Ask him about it.

>give blanky
You can't see any such thing.

>give blanky to george
You can't see any such thing.

>give george blanky
You can't see any such thing.

>give blanky to george
You can't see any such thing.

>give blanky
You can't see any such thing.

>give george the blanky
You can't see any such thing.

>x blanky
You can't see any such thing.

>i
You are carrying:
  Blanket
  Wheel
  Plastic Toy Cart
  Wallet (open but empty)
  Key

>give blanket to george
You proudly hand the blanket to George. You're about to reprimand "Do you know the trouble I went through to get that, Mister?" when George squeals in delight. You can't help but laugh. You decide to keep that thought to yourself because George doesn't need to know that.

    *** The End ***

Would you like to RESTART, RESTORE a saved game, QUIT or UNDO the last command?

* * *

>w
Parking Lot
A large parking lot. There aren't a lot of cars in the lot right now, but a couple hours later and it'll be jam packed. Your car is parked in front of you. To the East is the Parent Waiting Room.

>take wallet
You can't see any such thing.

>open car
You open Car, revealing Wallet.

* * *

>open wallet
You open Wallet, revealing Dollar Bill.

>take dollar bill
Taken.

>w
You can't go that way.

>e
Parent Waiting Room
The room is a modestly sized rectangular room. Lining the pastel yellow walls are wooden armchairs. Against the north wall is the Reception Desk. There is a girl sitting behind the desk. To the West is the Parking Lot. To the South is the Office.

>e
You can't go that way.

>speak to girl
I didn't understand that sentence.

>talk to girl
She looks up briefly, then back down to her phone. She nonchalantly says "You're with Miss Green. To get to her classroom, you'll have to go through the office.

* * *

>w
Parking Lot
A large parking lot. There aren't a lot of cars in the lot right now, but a couple hours later and it'll be jam packed. Your car is parked in front of you. To the East is the Parent Waiting Room.

>open car
You open Car, revealing Wallet.

* * *

>take dollar bill
Taken.

>e
Parent Waiting Room
The room is a modestly sized rectangular room. Lining the pastel yellow walls are wooden armchairs. Against the north wall is the reception desk. There is a girl sitting behind the desk. To the West is the Parking Lot. To the South is the Office.

>give girl dollar
You hand her the Dollar Bill, and she nods her head to the Ceramic Pig. "You can take four quarters." You take the Ceramic Pig, and pull the rubber stopper from under it. Gently shaking the Ceramic Pig, four quarters fall into your palm. You put the Ceramic Pig back, and thank the girl.

>s
Office
The teachers don't really need to grade anything, so only the administration workers need cubicles. There are only four cubicles, two on each side of the walk way at the center. As you scan the room, a woman walks past. Her nametag reads "Miss Graham: Headmaster". To the North is the Parent Waiting Room. To the West is the Lounge. To the South is the Classroom.

* * *

>w
Playground
An open grassy space for the children to play in. There is a small plastic jungle gym at the center of the space for the older kids to play in. Next to it is a large wooden sandbox. Scattered around the grass are jump ropes, balls, and a plastic toy cart. Sounds of giggling children come from the Classroom, to the East.

>take brown rag
Taken.

>e
Classroom
A somewhat large room, walls covered in posters. The floor is cluttered with toys and furniture. Small children run around, screaming at each other. Some of the younger children sit dumbly on a brightly colored rug, chewing on some poor plastic toy. There is a large window on the west wall, overlooking the playground. Along the four walls are cubby holes. The Office is to the North, and the Playground is to the West. Mrs. Green, the teacher, stands by the window, consoling a crying child.

* * *

>put rag in machine
You put Brown Rag into Washer-Dryer Machine.

You adjust the options to "Speed Wash" and press the Power Button. The washer-dryer whirs to life, and you wait 15 minutes before a beeping sound blares from the machine. You take out George's blanket, now soft and fresh (and blue).

>e
Office
The teachers don't really need to grade anything, so only the administration workers need cubicles. There are only four cubicles, two on each side of the walk way at the center. As you scan the room, a woman walks past. Her nametag reads "Miss Graham: Headmaster". To the North is the Parent Waiting Room. To the West is the Lounge. To the South is the Classroom.

* * *

>s
Classroom
A somewhat large room, walls covered in posters. The floor is cluttered with toys and furniture. Small children run around, screaming at each other. Some of the younger children sit dumbly on a brightly colored rug, chewing on some poor plastic toy. There is a large window on the west wall, overlooking the playground. Along the four walls are cubby holes. The Office is to the North, and the Playground is to the West. Mrs. Green, the teacher, stands by the window, consoling a crying child.

>give george blanket
You proudly hand the blanket to George. You're about to reprimand "Do you know the trouble I went through to get that, Mister?" when George squeals in delight. You can't help but laugh. You decide to keep that thought to yourself because George doesn't need to know that.

    *** The End ***

Would you like to RESTART, RESTORE a saved game, QUIT or UNDO the last command?

Please give one of the answers above.

Would you like to RESTART, RESTORE a saved game, QUIT or UNDO the last command?

>i
Please give one of the answers above.

Would you like to RESTART, RESTORE a saved game, QUIT or UNDO the last command?

>undo
Classroom
[Previous turn undone.]

>i
You are carrying:
  Blanket

* * *

>open wallet
You open Wallet, revealing Dollar Bill.

>take dollar
Taken.

>e
Parent Waiting Room
The room is a modestly sized rectangular room. Lining the pastel yellow walls are wooden armchairs. Against the north wall is the reception desk. There is a girl sitting behind the desk. To the West is the Parking Lot. To the South is the Office.

>give dollar to girl
You hand her the Dollar Bill, and she nods her head to the Ceramic Pig. You can take four quarters." You take the Ceramic Pig, and pull the rubber stopper from under it. Gently shaking the Ceramic Pig, four quarters fall into your palm. You put the Ceramic Pig back, and thank the girl.

>s
Office
The teachers don't really need to grade anything, so only the administration workers need cubicles. There are only four cubicles, two on each side of the walk way at the center. As you scan the room, a woman walks past. Her nametag reads "Miss Graham: Headmaster". To the North is the Parent Waiting Room. To the West is the Lounge. To the South is the Classroom.

* * *

>s
Classroom
A somewhat large room, walls covered in posters. The floor is cluttered with toys and furniture. Small children run around, screaming at each other. Some of the younger children sit dumbly on a brightly colored rug, chewing on some poor plastic toy. There is a large window on the west wall, overlooking the playground. Along the four walls are cubby holes. The Office is to the North, and the Playground is to the West. Mrs. Green, the teacher, stands by the window, consoling a crying child.

>x rug
The large blue rug is spread across the floor. Along with the colorful shapes and images are woven into the rug, you also notice some unidentified sploches. You'd rather not ask.

>x posters
Cartoon flowers and colorful butterflies smile from the posters. A large poster with the alphabet dominates the center of the room.

>x toys
Teddy bears, alphabet blocks, puzzle pieces are srewn across the rug. At the end of the day, you're going to have to pick the saliva-covered toys all up.

>x furniture
Some plastic chairs and tables for children. The kids have turned the table over and are building some kind of tower.

>x children
You wave at the younger kids sitting on the floor. The stare at you and crack a smile before returning to their designated toy.

>x window
Sunlight flows into the room, highlighting specks of dust floating in the air. The window overlooks the playground to the west. It is not recess yet, and there are no children outside.

>x cubby holes
A wooden shelf divided into small cubes. Children can put their belongings in here. A quick glance and you see small backpacks and lunchbags.

>take backpacks
These aren't for you to take, nor do you need them.

>take lunchbags
These aren't for you to take, nor do you need them.

>w
Playground
An open grassy space for the children to play in. There is a small plastic jungle gym at the center of the space for the older kids to play in. Next to it is a large wooden sandbox. Scattered around the grass is are jump ropes, balls, and a plastic toy cart. Sounds of giggling children come from the Classroom, to the East.

You can see Wheel here.

>e
Classroom
A somewhat large room, walls covered in posters. The floor is cluttered with toys and furniture. Small children run around, screaming at each other. Some of the younger children sit dumbly on a brightly colored rug, chewing on some poor plastic toy. There is a large window on the west wall, overlooking the playground. Along the four walls are cubby holes. The Office is to the North, and the Playground is to the West. Mrs. Green, the teacher, stands by the window, consoling a crying child.

>w
Playground
An open grassy space for the children to play in. There is a small plastic jungle gym at the center of the space for the older kids to play in. Next to it is a large wooden sandbox. Scattered around the grass is are jump ropes, balls, and a plastic toy cart. Sounds of giggling children come from the Classroom, to the East.

You can see Wheel here.

>x cart
Red body, yellow roof. The Cozy Coupe: a classic. You push the cart a little bit, and discover one of the wheels don't move.

>x wheels
You can't see any such thing.

* * *

>x wheel
Black plastic wheel attached to the cart. Wheel is detachable.

>x wheel
Black plastic wheel attached to the cart. Wheel is detachable.

>take wheel
Looks like there's a Brown Rag inside the hollow of the wheel.

>take brown rag
Taken.

>x brown rag
On closer inspection, you realize that the Brown Rag is a blanket soaked with mud. It must be George's soft blue Blanky! You can't give it back to George like this! There must be a way to fix this... maybe Miss Graham can help.

>s
You can't go that way.

* * *

>w
You can't go that way.

>e
Classroom
A somewhat large room, walls covered in posters. The floor is cluttered with toys and furniture. Small children run around, screaming at each other. Some of the younger children sit dumbly on a brightly colored rug, chewing on some poor plastic toy. There is a large window on the west wall, overlooking the playground. Along the four walls are cubby holes. The Office is to the North, and the Playground is to the West. Mrs. Green, the teacher, stands by the window, consoling a crying child.

* * *

>n
Office
The teachers don't really need to grade anything, so only the administration workers need cubicles. There are only four cubicles, two on each side of the walk way at the center. As you scan the room, a woman walks past. Her nametag reads "Miss Graham: Headmaster". To the North is the Parent Waiting Room. To the West is the Lounge. To the South is the Classroom.

>speak to mrs. graham
You can't see any such thing.

>speak to miss graham
You approach Miss Graham, and she turns to you. She smiles and says "Hello, Miss White. I hope your first day is going well. If you have any problems or questions, please feel free to ask me."

>ask miss graham about blanket
You tell her about George's blanket, and ask if she might know anything. She replies, "Hmm, I'm not sure where it is. The kids usually play in the playground, so you could check there."

I beg your pardon?

>ask miss graham about brown rag
You show her the brown rag and explain the situation. She laughs and says, "Don't worry. There's a washer-dryer machine in the faculty lounge. You can wash the blanket there.

>i
You are carrying:
  Brown Rag
  Wheel
  Quarters

>s
Classroom
A somewhat large room, walls covered in posters. The floor is cluttered with toys and furniture. Small children run around, screaming at each other. Some of the younger children sit dumbly on a brightly colored rug, chewing on some poor plastic toy. There is a large window on the west wall, overlooking the playground. Along the four walls are cubby holes. The Office is to the North, and the Playground is to the West. Mrs. Green, the teacher, stands by the window, consoling a crying child.

>w
Playground
An open grassy space for the children to play in. There is a small plastic jungle gym at the center of the space for the older kids to play in. Next to it is a large wooden sandbox. Scattered around the grass is are jump ropes, balls, and a plastic toy cart. Sounds of giggling children come from the Classroom, to the East.

>en
That's not a verb I recognise.

>e
Classroom
A somewhat large room, walls covered in posters. The floor is cluttered with toys and furniture. Small children run around, screaming at each other. Some of the younger children sit dumbly on a brightly colored rug, chewing on some poor plastic toy. There is a large window on the west wall, overlooking the playground. Along the four walls are cubby holes. The Office is to the North, and the Playground is to the West. Mrs. Green, the teacher, stands by the window, consoling a crying child.

* * *

>n
Office
The teachers don't really need to grade anything, so only the administration workers need cubicles. There are only four cubicles, two on each side of the walk way at the center. As you scan the room, a woman walks past. Her nametag reads "Miss Graham: Headmaster". To the North is the Parent Waiting Room. To the West is the Lounge. To the South is the Classroom.

>w
Lounge
There is a microwave and a sink at the counter. At the center of the room is a round table. Because this is a preschool, there is also a washer-dryer machine in the far corner.

>x washer-dryer
A combination of both, this is a practical necessity for a preschool! The only problem is you need to insert quarters into the machine to unlock the machine. There should be a bowl full of quarters on the table.

>x microwave
A microwave means you can eat hot lunches here!

>x sink
Just your average Grade A stainless steel sink.

>x drawers
You can't see any such thing.

>x counter
A marble surface counter with a sink and a microwave on top.

>x table
The faculty usually eat lunch on this table. "Though, they don't do a very good job of cleaning it up" you think to yourself as you examine a blob of ketchup on the surface. There's a bowl at the center of the table.

>x ketchup
Dried Ketchup -- gross.

>take ketchup
Do you really want to take that?

>x bowl
The bowl should have quarters for the Washer-Dryer machine, but it's empty! "It must've been that girl at the front desk! I saw a ceramic pig thing on the reception desk...! There must be coins in there." you think to yourself.

>take bowl
You don't need that right now.

>i
You are carrying:
  Brown Rag
  Wheel
  Quarters

>x washer-dryer
A combination of both, this is a practical necessity for a preschool! The only problem is you need to insert quarters into the machine to unlock the machine. There should be a bowl full of quarters on the table.

* * *

>e
Parent Waiting Room
The room is a modestly sized rectangular room. Lining the pastel yellow walls are wooden armchairs. Against the north wall is the reception desk. There is a girl sitting behind the desk. To the West is the Parking Lot. To the South is the Office.

>xwooden arm chair
That's not a verb I recognise.

>x wooden arm chair
You can't see any such thing.

>x wooden arm chair
You can't see any such thing.

>x wooden armchair
You can't see any such thing.

>x armchairs
You can't see any such thing.

>x armchari
You can't see any such thing.

>x armchair
Wooden armchairs. Parents usually sit on the chairs as they wait for their kids. It's a way to get them to calm down after a hectic day of work.

>x potted plant
A leafy addition to the room. The plant is growing well.

>x small pig ceramic pig
You can't see any such thing.

>x small ceramic pig
You can't see any such thing.

>x ceramic pig
A small pig ceramic pig that fits nicely into the palm of your hand. When you shake it, a loud clinking sounds the room.

* * *

>take ceramic pig
You ask if you can take the Ceramic Pig, but the girl at the desk says "Of course not. That's my bus money. I need a dollar to take the bus, and those quarter's are gonna get me home. If you can give me a dollar bill or something, then you can take it." You recall that you left your wallet inside the car.

>l
Parent Waiting Room
The room is a modestly sized rectangular room. Lining the pastel yellow walls are wooden armchairs. Against the north wall is the reception desk. There is a girl sitting behind the desk. To the West is the Parking Lot. To the South is the Office.

* * *

>w
Parking Lot
A large parking lot. There aren't a lot of cars in the lot right now, but a couple hours later and it'll be jam packed. Your car is parked in front of you. To the East is the Parent Waiting Room.

>go in the car
That's not something you can enter.

>go get money from car
You can't see any such thing.

>go get wallet from car
You can't see any such thing.

>unlock car
(with Key)
You unlock Car.

>open door
You can't see any such thing.

>get wallet from car
You can't see any such thing.

>take wallet
You can't see any such thing.

>open car
After pulling the door open, you stick your head into car. After rummaging around, you find your wallet lying under the carseat.

>x car seat
I only understood you as far as wanting to examine Car.

>x carseat
Faded brown cotton. There is a single stain from that one time you accidentally dropped your morning coffee. War scenes flash through your head as you recall that day.

>take wallet
Taken.

>l
Parking Lot
A large parking lot. There aren't a lot of cars in the lot right now, but a couple hours later and it'll be jam packed. Your car is parked in front of you. To the East is the Parent Waiting Room.

>e
Parent Waiting Room
The room is a modestly sized rectangular room. Lining the pastel yellow walls are wooden armchairs. Against the north wall is the reception desk. There is a girl sitting behind the desk. To the West is the Parking Lot. To the South is the Office.

* * *

>x reception desk
The desk is very large, taking up almost half of the wall. There are a number of little trinkets and decorations including a potted plant and a ceramic pig. There is a girl sitting behind the desk.

>give money to girl
You can't see any such thing.

>give dollar to girl
You can't see any such thing.

>talk to girl
She looks up briefly, then back down to her phone. She nonchalantly says, "You're with Miss Green. To get to her classroom, you'll have to go through the office."

>give girl dollar
You can't see any such thing.

>give girl dollar bill
You can't see any such thing.

>give dollar to the gir
You can't see any such thing.

>give dollar to the girl
You can't see any such thing.

>give dollar bill to girl
You can't see any such thing.

>give dollar bill to the girl
You can't see any such thing.

>Give Girl Dollar Bill
You can't see any such thing.

>l
Parent Waiting Room
The room is a modestly sized rectangular room. Lining the pastel yellow walls are wooden armchairs. Against the north wall is the reception desk. There is a girl sitting behind the desk. To the West is the Parking Lot. To the South is the Office.

>i
You are carrying:
  Wallet (closed)
  Key

>take dollar bill
You can't see any such thing.

>open wallet
You open the wallet, revealing a dollar bill, hastily shoved into the bill compartment.

>take dollar bill
Taken.

>give dollar bill to girl
You hand her the Dollar Bill, and she nods her head to the Ceramic Pig. "You can take four quarters." You take the Ceramic Pig, and pull the rubber stopper from under it. Gently shaking the Ceramic Pig, four quarters fall into your palm. You put the Ceramic Pig back, and thank the girl.

>speak to girl
She looks up briefly, then back down to her phone. She nonchalantly says, "You're with Miss Green. To get to her classroom, you'll have to go through the office."

>l
Parent Waiting Room
The room is a modestly sized rectangular room. Lining the pastel yellow walls are wooden armchairs. Against the north wall is the reception desk. There is a girl sitting behind the desk. To the West is the Parking Lot. To the South is the Office.

* * *

>s
Office
The teachers don't really need to grade anything, so only the administration workers need cubicles. There are only four cubicles, two on each side of the walk way at the center. As you scan the room, a woman walks past. Her nametag reads "Miss Graham: Headmaster". To the North is the Parent Waiting Room. To the West is the Lounge. To the South is the Classroom.

>s
Classroom
A somewhat large room, walls covered in posters. The floor is cluttered with toys and furniture. Small children run around, screaming at each other. Some of the younger children sit dumbly on a brightly colored rug, chewing on some poor plastic toy. There is a large window on the west wall, overlooking the playground. Along the four walls are cubby holes. The Office is to the North, and the Playground is to the West. Miss Green, the teacher, stands by the window, consoling a crying child.

* * *

>s
Office
The teachers don't really need to grade anything, so only the administration workers need cubicles. There are only four cubicles, two on each side of the walk way at the center. As you scan the room, a woman walks past. Her nametag reads "Miss Graham: Headmaster". To the North is the Parent Waiting Room. To the West is the Lounge. To the South is the Classroom.

* * *

>s
Classroom
A somewhat large room, walls covered in posters. The floor is cluttered with toys and furniture. Small children run around, screaming at each other. Some of the younger children sit dumbly on a brightly colored rug, chewing on some poor plastic toy. There is a large window on the west wall, overlooking the playground. Along the four walls are cubby holes. The Office is to the North, and the Playground is to the West. Miss Mary, the teacher, stands by the window, consoling a crying child.

>w
Playground
An open grassy space for the children to play in. There is a small plastic jungle gym at the center of the space for the older kids to play in. Next to it is a large wooden sandbox. Scattered around the grass are jump ropes, balls, and a plastic toy cart. Sounds of giggling children come from the Classroom, to the East.

>take brown cloth
Taken.

>drop blanky
Dropped.

>i
You are carrying:
  Key

>take blanky
Taken.

>n
You can't go that way.

>we
That's not a verb I recognise.

>e
Classroom
A somewhat large room, walls covered in posters. The floor is cluttered with toys and furniture. Small children run around, screaming at each other. Some of the younger children sit dumbly on a brightly colored rug, chewing on some poor plastic toy. There is a large window on the west wall, overlooking the playground. Along the four walls are cubby holes. The Office is to the North, and the Playground is to the West. Miss Mary, the teacher, stands by the window, consoling a crying child.

* * *

>x north wall
I only understood you as far as wanting to examine north.

>x reception desk
The desk is very large, taking up almost half of the wall. There are a number of little trinkets and decorations including a potted plant and a ceramic pig. There is a girl sitting behind the desk.

>x clipboard
You can't see any such thing.

>x shelf
You can't see any such thing.

>x top level of shelf
You can't see any such thing.

>x top shelf
You can't see any such thing.

>x potted plant
A leafy addition to the room. The plant is growing well.

>take plant
That's hardly portable.

>x pig
A small pig ceramic pig that fits nicely into the palm of your hand. When you shake it, a loud clinking sounds the room.

* * *

>take pig
You ask if you can take the Ceramic Pig, but the girl at the desk says "Of course not. That's my bus money. I need a dollar to take the bus, and those quarter's are gonna get me home. If you can give me a dollar bill or something, then you can take it." You recall that you left your wallet inside the car.

>steal pig
That's not a verb I recognise.

>talk to girl
She looks up briefly, then back down to her phone. She nonchalantly says, "You're with Miss Green. To get to her classroom, you'll have to go through the office.

>go to car
You can't see any such thing.

>x car
You can't see any such thing.

>l
Parent Waiting Room
The room is a modestly sized rectangular room. Lining the pastel yellow walls are wooden armchairs. Against the north wall is the reception desk. There is a girl sitting behind the desk. To the West is the Parking Lot. To the South is the Office.

You can see Trinkets here.

>w
Parking Lot
A large parking lot. There aren't a lot of cars in the lot right now, but a couple hours later and it'll be jam packed. Your car is parked in front of you. To the East is the Parent Waiting Room.

* * *

>take wallet
Taken.

>e
Parent Waiting Room
The room is a modestly sized rectangular room. Lining the pastel yellow walls are wooden armchairs. Against the north wall is the reception desk. There is a girl sitting behind the desk. To the West is the Parking Lot. To the South is the Office.

You can see Trinkets here.

>give girl money
You can't see any such thing.

>open wallet
You open Wallet, revealing Dollar Bill.

* * *

>take dollar bill
Taken.

>give dollar bill to girl
You hand her the Dollar Bill, and she nods her head to the Ceramic Pig. You can take four quarters." You take the Ceramic Pig, and pull the rubber stopper from under it. Gently shaking the Ceramic Pig, four quarters fall into your palm. You put the Ceramic Pig back, and thank the girl.

>talk to girl
She looks up briefly, then back down to her phone. She nonchalantly says, "You're with Miss Green. To get to her classroom, you'll have to go through the office.

>s
Office
The teachers don't really need to grade anything, so only the administration workers need cubicles. There are only four cubicles, two on each side of the walk way at the center. As you scan the room, a woman walks past. Her nametag reads "Miss Graham: Headmaster". To the North is the Parent Waiting Room. To the West is the Lounge. To the South is the Classroom.

>talk to ms graham
You can't see any such thing.

>talk to miss graham
You approach Miss Graham, and she turns to you. She smiles and says "Hello, Miss White. I hope your first day is going well. If you have any problems or questions, please feel free to ask me."

>ask miss graham about cubicles
There is no reply.

>ask miss graham about classroom
There is no reply.

>s
Classroom
A somewhat large room, walls covered in posters. The floor is cluttered with toys and furniture. Small children run around, screaming at each other. Some of the younger children sit dumbly on a brightly colored rug, chewing on some poor plastic toy. There is a large window on the west wall, overlooking the playground. Along the four walls are cubby holes. The Office is to the North, and the Playground is to the West. Mrs. Green, the teacher, stands by the window, consoling a crying child.

>x floor
You can't see any such thing.

>x toys
Teddy bears, alphabet blocks, puzzle pieces are srewn across the rug. At the end of the day, you're going to have to pick the saliva-covered toys all up.

* * *

>x furniture
Some plastic chairs and tables for children. The kids have turned the table over and are building some kind of tower.

>x window
Sunlight flows into the room, highlighting specks of dust floating in the air. The window overlooks the playground to the west. It is not recess yet, and there are no children outside.

>look at window
Sunlight flows into the room, highlighting specks of dust floating in the air. The window overlooks the playground to the west. It is not recess yet, and there are no children outside.

>x playground
You can't see any such thing.

>x shelves
You can't see any such thing.

>x cubby holes
A wooden shelf divided into small cubes. Children can put their belongings in here. A quick glance and you see small backpacks and lunchbags.

>talk to childre
You can't see any such thing.

>talk to children
You can only do that to something animate.

>talk to mrs. green
You walk up to Mrs. Green, and say "Hello.". She sighs in relief and says, "Thank the Lord that you're here! This is George," she says, gesturing to the crying child. "Right now, I need you to get him to stop crying. I really need to get the kids in order, and a wailing child does not help!" George, a small boy, looks to you as Mrs. Green hurries away to settle another dispute.

That's not a verb I recognise.

>talk to george
You ask George what's wrong. He wails, "B-blanky is gone." Blanky? What's that? Ask him about it.

>ask about blanky
You can't see any such thing.

>ask george about blanky
"Soft blanky. Is blue, and soft. I want it!" You ask him where he saw it last, to which he replies "Playground! I ride car and put it on my head. It fall down and I losed it. Then the car broke."

>l
Classroom
A somewhat large room, walls covered in posters. The floor is cluttered with toys and furniture. Small children run around, screaming at each other. Some of the younger children sit dumbly on a brightly colored rug, chewing on some poor plastic toy. There is a large window on the west wall, overlooking the playground. Along the four walls are cubby holes. The Office is to the North, and the Playground is to the West. Mrs. Green, the teacher, stands by the window, consoling a crying child.

>s
You can't go that way.

* * *

>e
You can't go that way.

>w
Playground
An open grassy space for the children to play in. There is a small plastic jungle gym at the center of the space for the older kids to play in. Next to it is a large wooden sandbox. Scattered around the grass is are jump ropes, balls, and a plastic toy cart. Sounds of giggling children come from the Classroom, to the East.

>x sandbox
A center for aspiring-architect toddlers to built their dream, er, mound.

>x grass
You can't see any such thing.

>x jump ropes
I only understood you as far as wanting to examine Jump Rope.

>x plastic toy cart
Red body, yellow roof. The Cozy Coupe: a classic. You push the cart a little bit, and discover one of the wheels don't move.

>x wheel
Black plastic wheel attached to the cart.

>x brown rag
On closer inspection, you realize that the blanket is soaked with mud from the grass. It must be George's soft blue Blanky! You can't give it back to George like this! There must be a way to fix this... maybe Miss Graham can help.

>take brown rag
Taken.

>w
You can't go that way.

* * *

>n
Office
The teachers don't really need to grade anything, so only the administration workers need cubicles. There are only four cubicles, two on each side of the walk way at the center. As you scan the room, a woman walks past. Her nametag reads "Miss Graham: Headmaster". To the North is the Parent Waiting Room. To the West is the Lounge. To the South is the Classroom.

>ask miss graham about blanky
There is no reply.

>talk to miss graham
You approach Miss Graham, and she turns to you. She smiles and says "Hello, Miss White. I hope your first day is going well. If you have any problems or questions, please feel free to ask me."

>ask miss graham about blanky
There is no reply.

>ask miss graham about brown rag
You show her the brown rag and explain the situation. She laughs and says, "Don't worry. There's a washer-dryer machine in the faculty lounge. You can wash the blanket there.

* * *

>w
Lounge
There is a microwave and a sink at the counter, below which are a couple of drawers. At the center of the room is a round table. Because this is a preschool, there is also a washer-dryer machine in the far corner.

>x washer-dryer
A combination of both, this is a practical necessity for a preschool! The only problem is you need to insert quarters into the machine to unlock the machine. There should be a bowl full of quarters on the table.

>insert quarters
What do you want to insert Quarters in?

>insert quarters in machine
Washer-Dryer Machine is closed.

>unlock machine
What do you want to unlock Washer-Dryer Machine with?

>unlock machine with quarters
You unlock Washer-Dryer Machine.

>insert brown rag in machine
Washer-Dryer Machine is closed.

>open machine
You open Washer-Dryer Machine.